You beg to the guard to let you free. "If you can't do the time, don't do the crime," he replies coldly. You'll go insane if you stay in prison any longer. Find a way to escape without being caught by the guard. Never be in the same room as him or he'll catch you. The only place you're safe from him is in the the cells.

Jail Break
A prison-escape game by tendo19 The release number is 1
Release 1 / Serial number 190422 / Inform 7 build 6M62 (I6/v6.33 lib 6/12N) SD

your cell
You're in a small cramped space with a thin mattress and a filthy toilet. Hide here if the security guard comes. You notice that your cell is not fully locked. Go south to leave your cell.

I beg your pardon?

I beg your pardon?

* * *

>.
That's not a verb I recognise.

* * *

>e
You can't go that way.

The security guard is in security checkpoint 2 and is headed towards cafeteria.

>e
East Security Room
There's cell room to the west and a security checkpoint to the south.

>s
security checkpoint 2
There's a security room to the north and the cafeteria to the west.

>s
Freedom
You're free! Now you don't have to sleep next to your stinky cellmate.

    *** Yay! ***

Would you like to RESTART, RESTORE a saved game, QUIT or UNDO the last command?

* * *

>s
security checkpoint 2
There's a security room to the north and the cafeteria to the west.

>w
Cafeteria
There's a cell room to the north, bathroom to the west, security checkpoint to the east, and another security checkpoint to the south.

>s
security checkpoint 1
There's a security room to the west and the cafeteria to the north.

>w
South Security Room
The bathroom is to the north and there's a security checkpoint to the east.

>n
Prison Bathroom
There's a cell room to the north and the cafeteria is to the east.

>n
Cell Room 1
There's another cell room to the east and the bathroom is to the south.

>s
Prison Bathroom
There's a cell room to the north and the cafeteria is to the east.

>e
Cafeteria
There's a cell room to the north, bathroom to the west, security checkpoint to the east, and another security checkpoint to the south.

>e
security checkpoint 2
There's a security room to the north and the cafeteria to the west.

>s
You can't go that way.

>w
Cafeteria
There's a cell room to the north, bathroom to the west, security checkpoint to the east, and another security checkpoint to the south.

>e
security checkpoint 2
There's a security room to the north and the cafeteria to the west.

>w
Cafeteria
There's a cell room to the north, bathroom to the west, security checkpoint to the east, and another security checkpoint to the south.

* * *

>e
security checkpoint 2
There's a security room to the north and the cafeteria to the west.

>n
East Security Room
There's cell room to the west and a security checkpoint to the south.

You can see a security guard here.

>s
security checkpoint 2
There's a security room to the north and the cafeteria to the west.

>n
East Security Room
There's cell room to the west and a security checkpoint to the south.

You can see a security guard here.

* * *

>e
You can't go that way.

The security guard is in security checkpoint 2 and is headed towards cafeteria.

>s
Cell Room 1
The cells are on the northern side of the room. There's another cell room to the east and the bathroom is to the south.

You can see a metal door here.

The security guard is in cafeteria and is headed towards security checkpoint 1.

>e
Cell Room 2
The cells are on the northern side of the room. There's another cell room to the west and the security room is to east. The cafeteria is to the south.

You can see a rusted metal door and Joe here.

The security guard is in security checkpoint 1 and is headed towards Storage Room.

>talk to the joe
"Sup Joe," you say.

"What do you want?" he replies.

You can ask him about the prison layout or the security guards.

The security guard is in Storage Room and is headed towards Prison Bathroom.

* * *

>e
You can't go that way.

The security guard is in security checkpoint 2 and is headed towards cafeteria.

>talk to joe
You must supply a noun.

Security guard heads to Cafeteria.

* * *

>e
You can't go that way.

The security guard is in security checkpoint 2 and is headed towards cafeteria.

>z
Time passes.

The security guard is in cafeteria and is headed towards security checkpoint 1.

>z
Time passes.

The security guard is in security checkpoint 1 and is headed towards Storage Room.

>z
Time passes.

The security guard is in Storage Room and is headed towards prison bathroom.

>z
Time passes.

The security guard is in prison bathroom and is headed towards Cell Room 1.

>z
Time passes.

You see the security guard heading to the next room.
The security guard is in Cell Room 1 and is headed towards Cell Room 2.

>s
Cell Room 1
The cells are on the northern side of the room.There's another cell room to the east and the bathroom is to the south.

You can see a metal door here.

The security guard is in Cell Room 2 and is headed towards Security Room.

>e
Cell Room 2
The cells are on the northern side of the room. There's another cell room to the west and the security room is to east. The cafeteria is to the south.

You can see a rusted metal door and Joe here.

The security guard is in Security Room and is headed towards security checkpoint 2.

>x door
Enter a six-digit pin code to unlock the rusted metal door.

The security guard is in security checkpoint 2 and is headed towards cafeteria.

Please enter the six-digit pin code.

>928369
**BUZZ**  Access granted

>open door
You open the rusted metal door.

The security guard is in cafeteria and is headed towards security checkpoint 1.

* * *

>go south
Cell Room 1
The cells are on the northern side of the room. There's another cell room to the east.

The security guard is in security checkpoint 2 and is headed towards cafeteria.

>go east
Cell Room 2
The cells are on the northern side of the room. There's another cell room to the west and the security room is to east. The cafeteria is to the south.

You can see a metal door and Joe here.

The security guard is in cafeteria and is headed towards security checkpoint 1.You see Joe. He has been in this prison for 50 years, so he probably knows a lot about it. Try talking to him.

>go south
(first opening the metal door)
It seems to be locked.

The security guard is in security checkpoint 1 and is headed towards Storage Room.You see Joe. He has been in this prison for 50 years, so he probably knows a lot about it. Try talking to him.

>talk to joe
"Sup Joe," you say.

"What do you want?" he replies.

You can ask him about the prison layout or the security guards or the door.
The security guard is in Storage Room and is headed towards Prison Bathroom.You see Joe. He has been in this prison for 50 years, so he probably knows a lot about it. Try talking to him.

>ask about the security guards
You can't see any such thing.

>ask him about security guards
There are three security guards in this prison. The first one walks around the prison. You should avoid being in the same room as him. He always takes same route, so you should be able to figure where he's headed.

One of them is guarding security checkpoint 1 and the last one is guarding security checkpoint 2. You need to find a way to sneak past all three of them if you want to escape. Whatever you do, don't make any noise.

The only place you're truly safe is in the cells. If the guard comes, just go into one of the cells and don't act suspicious.

The security guard is in Prison Bathroom and is headed towards Cell Room 1.You see Joe. He has been in this prison for 50 years, so he probably knows a lot about it. Try talking to him.
The guard is coming! Hide in my cell!

>go north
Joe's Cell
Joe's room is a lot stinkier than your's. The smell is probably coming from his toilet. You're safe from the guard when you're in this room.

The security guard is in Cell Room 1 and is headed towards Cell Room 2.

>stay
That's not a verb I recognise.

>z
Time passes.

You see the security guard heading to the next room.
The security guard is in Cell Room 2 and is headed towards Security Room.

>go south
Cell Room 2
The cells are on the northern side of the room. There's another cell room to the west and the security room is to east. The cafeteria is to the south.

You can see a metal door and Joe here.

The security guard is in Security Room and is headed towards security checkpoint 2.You see Joe. He has been in this prison for 50 years, so he probably knows a lot about it. Try talking to him.

>go south
(first opening the metal door)
It seems to be locked.

The security guard is in security checkpoint 2 and is headed towards cafeteria.You see Joe. He has been in this prison for 50 years, so he probably knows a lot about it. Try talking to him.

>talk to joe
"Sup Joe," you say.

"What do you want?" he replies.

You can ask him about the prison layout or the security guards or the door.
The security guard is in cafeteria and is headed towards security checkpoint 1.You see Joe. He has been in this prison for 50 years, so he probably knows a lot about it. Try talking to him.

>ask him about the door
If you  examine the door closely, you'll see that you need a pincode to unlock the door. The security room is east from here, so maybe you'll be able to find some clues there.

The security guard is in security checkpoint 1 and is headed towards Storage Room.You see Joe. He has been in this prison for 50 years, so he probably knows a lot about it. Try talking to him.

>go east
Security Room
There's cell room to the west and a security checkpoint to the south. Don't go south unless you can sneak past the guard.

You can see Security camera monitor, a bulletin board (in which is a note) and Trash can (in which is Piece of paper) here.

The security guard is in Storage Room and is headed towards Prison Bathroom.

>x bulletin board
It has a single piece of paper pinned on it.

In the bulletin board is a note.

The security guard is in Prison Bathroom and is headed towards Cell Room 1.

>w
Cell Room 2
The cells are on the northern side of the room. There's another cell room to the west and the security room is to east. The cafeteria is to the south.

You can see a metal door and Joe here.

The security guard is in Cell Room 1 and is headed towards Cell Room 2.You see Joe. He has been in this prison for 50 years, so he probably knows a lot about it. Try talking to him.

>n
Joe's Cell
Joe's room is a lot stinkier than your's. The smell is probably coming from his toilet. You're safe from the guard when you're in this room.

You see the security guard heading to the next room.
The security guard is in Cell Room 2 and is headed towards Security Room.

>s
Cell Room 2
The cells are on the northern side of the room. There's another cell room to the west and the security room is to east. The cafeteria is to the south.

You can see a metal door and Joe here.

The security guard is in Security Room and is headed towards security checkpoint 2.You see Joe. He has been in this prison for 50 years, so he probably knows a lot about it. Try talking to him.

>e
Security Room
There's cell room to the west and a security checkpoint to the south. Don't go south unless you can sneak past the guard.

You can see Security camera monitor, a bulletin board (in which is a note) and Trash can (in which is Piece of paper) here.

The security guard is in security checkpoint 2 and is headed towards cafeteria.

>x note
It reads: Door Pin Code: 9283 . . . a piece of the paper is missing. There's also an arrow pointing from right to left. What could the last two digits be?

The security guard is in cafeteria and is headed towards security checkpoint 1.

>x trash can
There's a tiny piece of paper inside.

In Trash can is Piece of paper.

The security guard is in security checkpoint 1 and is headed towards Storage Room.

>x paper
There's a number written on it. It is the number 69.

The security guard is in Storage Room and is headed towards Prison Bathroom.

>w
Cell Room 2
The cells are on the northern side of the room. There's another cell room to the west and the security room is to east. The cafeteria is to the south.

You can see a metal door and Joe here.

The security guard is in Prison Bathroom and is headed towards Cell Room 1.You see Joe. He has been in this prison for 50 years, so he probably knows a lot about it. Try talking to him.
The guard is coming! Hide in my cell!

>n
Joe's Cell
Joe's room is a lot stinkier than your's. The smell is probably coming from his toilet. You're safe from the guard when you're in this room.

The security guard is in Cell Room 1 and is headed towards Cell Room 2.

>z
Time passes.

You see the security guard heading to the next room.
The security guard is in Cell Room 2 and is headed towards Security Room.

>z
Time passes.

The security guard is in Security Room and is headed towards security checkpoint 2.

>s
Cell Room 2
The cells are on the northern side of the room. There's another cell room to the west and the security room is to east. The cafeteria is to the south.

You can see a metal door and Joe here.

The security guard is in security checkpoint 2 and is headed towards cafeteria.You see Joe. He has been in this prison for 50 years, so he probably knows a lot about it. Try talking to him.

>x door
This door is headed south. Enter pin code to unlock the metal door.

The security guard is in cafeteria and is headed towards security checkpoint 1.You see Joe. He has been in this prison for 50 years, so he probably knows a lot about it. Try talking to him.

Please enter the pin code.

>928369
Incorrect pin code, door remains locked.

Would you like to try again? (Yes or No)

>yes
Please enter the pin code.

>963829
**BUZZ**  Access granted. Door leads to the south.

>s
cafeteria
The cafeteria is empty. There's a cell room to the north, bathroom to the west, security checkpoint to the east, and another security checkpoint to the south. Don't go east or south unless you can sneak past the guard.

You can see a metal door and Ceramic plate here.

The security guard is in security checkpoint 1 and is headed towards Storage Room.

>take the plate
Taken.

The security guard is in Storage Room and is headed towards Prison Bathroom.

>x plate
The plate is smothered with spaghetti sauce and other remnants from last night's dinner. It will surely shatter into pieces if you drop it.

The security guard is in Prison Bathroom and is headed towards Cell Room 1.

>n
Cell Room 2
The cells are on the northern side of the room. There's another cell room to the west and the security room is to east. The cafeteria is to the south.

You can see a metal door and Joe here.

The security guard is in Cell Room 1 and is headed towards Cell Room 2.You see Joe. He has been in this prison for 50 years, so he probably knows a lot about it. Try talking to him.

>n
Joe's Cell
Joe's room is a lot stinkier than your's. The smell is probably coming from his toilet. You're safe from the guard when you're in this room.

You see the security guard heading to the next room.
The security guard is in Cell Room 2 and is headed towards Security Room.

* * *

>s
Cell Room 2
The cells are on the northern side of the room. There's another cell room to the west and the security room is to east. The cafeteria is to the south.

You can see a metal door and Joe here.

The security guard is in Security Room and is headed towards security checkpoint 2.You see Joe. He has been in this prison for 50 years, so he probably knows a lot about it. Try talking to him.

>w
Cell Room 1
The cells are on the northern side of the room. There's another cell room to the east.

The security guard is in security checkpoint 2 and is headed towards cafeteria.

>n
your cell
You're in a small cramped space with a thin mattress and a filthy toilet. Hide here if the security guard comes. You notice that your cell is not fully locked. Go south to leave your cell. 

The security guard is in cafeteria and is headed towards security checkpoint 1.

>z
Time passes.

The security guard is in security checkpoint 1 and is headed towards Storage Room.

>z
Time passes.

The security guard is in Storage Room and is headed towards Prison Bathroom.

>z
Time passes.

The security guard is in Prison Bathroom and is headed towards Cell Room 1.

>z
Time passes.

You see the security guard heading to the next room.
The security guard is in Cell Room 1 and is headed towards Cell Room 2.

>s
Cell Room 1
The cells are on the northern side of the room. There's another cell room to the east.

The security guard is in Cell Room 2 and is headed towards Security Room.

>s
You can't go that way.

The security guard is in Security Room and is headed towards security checkpoint 2.

>e
Cell Room 2
The cells are on the northern side of the room. There's another cell room to the west and the security room is to east. The cafeteria is to the south.

You can see a metal door and Joe here.

The security guard is in security checkpoint 2 and is headed towards cafeteria.You see Joe. He has been in this prison for 50 years, so he probably knows a lot about it. Try talking to him.

>s
cafeteria
The cafeteria is empty. There's a cell room to the north, bathroom to the west, security checkpoint to the east, and another security checkpoint to the south. Don't go east or south unless you can sneak past the guard.

You can see a metal door and a security guard here.

The security guard is in cafeteria and is headed towards security checkpoint 1.

    *** The security guard sees you and chases you. You trip on a pebble and get caught. You have been moved to a higher security cell. Good luck escaping from there. ***

Would you like to RESTART, RESTORE a saved game, QUIT or UNDO the last command?

>undo
Cell Room 2
[Previous turn undone.]

>z
Time passes.

The security guard is in cafeteria and is headed towards security checkpoint 1.You see Joe. He has been in this prison for 50 years, so he probably knows a lot about it. Try talking to him.

>s
cafeteria
The cafeteria is empty. There's a cell room to the north, bathroom to the west, security checkpoint to the east, and another security checkpoint to the south. Don't go east or south unless you can sneak past the guard.

You can see a metal door here.

The security guard is in security checkpoint 1 and is headed towards Storage Room.

>z
Time passes.

The security guard is in Storage Room and is headed towards Prison Bathroom.

* * *

>z
Time passes.

The security guard is in Prison Bathroom and is headed towards Cell Room 1.

>w
Prison Bathroom
There's nothing much to do here. The cafeteria is to the east and the storage room is to the south.

You can see storage door here.

The security guard is in Cell Room 1 and is headed towards Cell Room 2.

>x door
Only the people working here have access to this room.

The security guard is in Cell Room 2 and is headed towards Security Room.

>e
cafeteria
The cafeteria is empty. There's a cell room to the north, bathroom to the west, security checkpoint to the east, and another security checkpoint to the south. Don't go east or south unless you can sneak past the guard.

You can see a metal door here.

The security guard is in Security Room and is headed towards security checkpoint 2.

>n
Cell Room 2
The cells are on the northern side of the room. There's another cell room to the west and the security room is to east. The cafeteria is to the south.

You can see a metal door and Joe here.

The security guard is in security checkpoint 2 and is headed towards cafeteria.You see Joe. He has been in this prison for 50 years, so he probably knows a lot about it. Try talking to him.

>n
Joe's Cell
Joe's room is a lot stinkier than your's. The smell is probably coming from his toilet. You're safe from the guard when you're in this room.

The security guard is in cafeteria and is headed towards security checkpoint 1.

>z
Time passes.

The security guard is in security checkpoint 1 and is headed towards Storage Room.

* * *

>z
Time passes.

The security guard is in Prison Bathroom and is headed towards Cell Room 1.

>z
Time passes.

The security guard is in Cell Room 1 and is headed towards Cell Room 2.

>z
Time passes.

You see the security guard heading to the next room.
The security guard is in Cell Room 2 and is headed towards Security Room.

>s
Cell Room 2
The cells are on the northern side of the room. There's another cell room to the west and the security room is to east. The cafeteria is to the south.

You can see a metal door and Joe here.

The security guard is in Security Room and is headed towards security checkpoint 2.You see Joe. He has been in this prison for 50 years, so he probably knows a lot about it. Try talking to him.

* * *

>e
Security Room
There's cell room to the west and a security checkpoint to the south. Don't go south unless you can sneak past the guard.

You can see Security camera monitor, a bulletin board (in which is a note) and Trash can (in which is Piece of paper) here.

The security guard is in security checkpoint 2 and is headed towards cafeteria.

>x security camera monitor
You can see one guard in security checkpoint 1 and another guard at security checkpoint 2. Those are the only ways to escape. You have to figure out a way to get past them without being noticed.

The security guard is in cafeteria and is headed towards security checkpoint 1.

>s
    *** The guard sees you. You sprint towards the exit, but he grabs you before you can get away.  ***

Would you like to RESTART, RESTORE a saved game, QUIT or UNDO the last command?

>undo
Security Room
[Previous turn undone.]

>w
Cell Room 2
The cells are on the northern side of the room. There's another cell room to the west and the security room is to east. The cafeteria is to the south.

You can see a metal door and Joe here.

The security guard is in security checkpoint 1 and is headed towards Storage Room.You see Joe. He has been in this prison for 50 years, so he probably knows a lot about it. Try talking to him.

>drop plate
You drop the plate, causing it to shatter. The janitor enters from the west and immediately starts cleaning the floor.

The security guard is in Storage Room and is headed towards Prison Bathroom.You see Joe. He has been in this prison for 50 years, so he probably knows a lot about it. Try talking to him.

>x janitor
You can't see any such thing.

>help janitor
That's not a verb I recognise.

>stal janitor
That's not a verb I recognise.

>n
Joe's Cell
Joe's room is a lot stinkier than your's. The smell is probably coming from his toilet. You're safe from the guard when you're in this room.

The security guard is in Prison Bathroom and is headed towards Cell Room 1.

>z
Time passes.

The security guard is in Cell Room 1 and is headed towards Cell Room 2.

* * *

>w
Cell Room 1
The cells are on the northern side of the room. There's another cell room to the east.

The security guard is in security checkpoint 2 and is headed towards cafeteria.

>e
Cell Room 2
The cells are on the northern side of the room. There's another cell room to the west and the security room is to east. The cafeteria is to the south.

You can see a metal door and Joe here.

The security guard is in cafeteria and is headed towards security checkpoint 1.You see Joe. He has been in this prison for 50 years, so he probably knows a lot about it. Try talking to him.

>s
cafeteria
The cafeteria is empty. There's a cell room to the north, bathroom to the west, security checkpoint to the east, and another security checkpoint to the south. Don't go east or south unless you can sneak past the guard.

You can see a metal door here.

The security guard is in security checkpoint 1 and is headed towards Storage Room.

* * *

>w
Prison Bathroom
There's nothing much to do here. The cafeteria is to the east and the storage room is to the south.

You can see storage door here.

The security guard is in Cell Room 1 and is headed towards Cell Room 2.

>s
(first opening storage door)

Storage Room
The bathroom is to the north and there's a security checkpoint to the east. The room is quite empty. Don't go east unless you can sneak past the guard.

You can see storage door and Security Uniform here.

The security guard is in Cell Room 2 and is headed towards Security Room.

>x security uniform
Use this to disguise as a guard. As long as you act natural, they shouldn't notice that you're a prisoner.

The security guard is in Security Room and is headed towards security checkpoint 2.

>use diguise
That's not a verb I recognise.

>e
    *** The guard sees you. You sprint towards the exit, but he grabs you before you can get away.  ***

Would you like to RESTART, RESTORE a saved game, QUIT or UNDO the last command?

>undo
Storage Room
[Previous turn undone.]

>wear dsguise
You can't see any such thing.

>wear uniform
(first taking Security Uniform)
You put on Security Uniform.

The security guard is in security checkpoint 2 and is headed towards cafeteria.

>e
Act natural, the exit is right in front of you!

The security guard is in cafeteria and is headed towards security checkpoint 1.

>e
Freedom
You're free!

The security guard is in security checkpoint 1 and is headed towards Storage Room.

    *** You win!! Now go back home and stay out of trouble. ***

Would you like to RESTART, RESTORE a saved game, QUIT or UNDO the last command?

* * *

>go south
Cell Room 1
The cells are on the northern side of the room. There's another cell room to the east.

The security guard is in security checkpoint 2 and is headed towards cafeteria.

>go north
your cell
You're in a small cramped space with a think mattress and a filthy toilet. You notice that your cell is not fully locked. Go south to leave your cell. 

Security is in cafeteria. Security guard is heading

>south
Cell Room 1
The cells are on the northern side of the room.There's another cell room to the east and the bathroom is to the south.

You can see a metal door here.

Security is in security checkpoint 1. Security guard is heading

>north
your cell
You're in a small cramped space with a think mattress and a filthy toilet. You notice that your cell is not fully locked. Go south to leave your cell. 

Security is in Storage Room. Security guard is heading

>z
Time passes.

Security is in prison bathroom. Security guard is heading

>z
Time passes.

Security is in Cell Room 1. Security guard is heading 
The security guard continues walking to the next room.

>z
Time passes.

Security is in Cell Room 2. Security guard is heading

>south
Cell Room 1
The cells are on the northern side of the room.There's another cell room to the east and the bathroom is to the south.

You can see a metal door here.

Security is in Security Room. Security guard is heading

>east
Cell Room 2
The cells are on the northern side of the room. There's another cell room to the west and the security room is to east. The cafeteria is to the south.

You can see a rusted metal door and Joe here.

Security is in security checkpoint 2. Security guard is heading

>talk to joe
You must supply a noun.

Security is in cafeteria. Security guard is heading

>talk to the joe
"How can I escape this place?" you ask.

"This prison is quite complex. You need to reach one of the security checkpoints without being caught," he replies. 

 You say, "Is there any way to sneak past the guards?"

"Whatever you do, don't be in the same room as the security guard. He always takes the same path so you should be able to figure out where he is."

Security is in security checkpoint 1. Security guard is heading

>south
(first opening the rusted metal door)
It seems to be locked.

Security is in Storage Room. Security guard is heading

>examine door
Enter six-digit code to unlock.

Security is in prison bathroom. Security guard is heading 
Please enter the six-digit locker pin code.

>112098
That's not a verb I recognise.

Please enter the six-digit locker pin code.

>talk
(to Joe)
"How can I escape this place?" you ask.

"This prison is quite complex. You need to reach one of the security checkpoints without being caught," he replies. 

 You say, "Is there any way to sneak past the guards?"

"Whatever you do, don't be in the same room as the security guard. He always takes the same path so you should be able to figure out where he is."

Security is in Cell Room 1. Security guard is heading 
Please enter the six-digit locker pin code.

>undo
Cell Room 2
[Previous turn undone.]

Please enter the six-digit locker pin code.

>undo
Cell Room 2
[Previous turn undone.]

Please enter the six-digit locker pin code.

>undo
Cell Room 2
[Previous turn undone.]

* * *

>go south
Cell Room 1
The cells are on the northern side of the room. There's another cell room to the east.

The security guard is in security checkpoint 2 and is headed towards cafeteria.

>go to the bathroom
You can't see any such thing.

>south
(first opening the metal door)
It seems to be locked.

Security is in cafeteria. Security guard is heading

>go east
Cell Room 2
The cells are on the northern side of the room. There's another cell room to the west and the security room is to east. The cafeteria is to the south.

You can see a rusted metal door and Joe here.

Security is in security checkpoint 1. Security guard is heading

>talk to joe
You must supply a noun.

Security is in Storage Room. Security guard is heading

>talk to the joe
"How can I escape this place?" you ask.

"This prison is quite complex. You need to reach one of the security checkpoints without being caught," he replies. 

 You say, "Is there any way to sneak past the guards?"

"Whatever you do, don't be in the same room as the security guard. He always takes the same path so you should be able to figure out where he is."

Security is in prison bathroom. Security guard is heading

>go north
Joe's Cell
...

Security is in Cell Room 1. Security guard is heading

>stay
That's not a verb I recognise.

>z
Time passes.

Security is in Cell Room 2. Security guard is heading 
The security guard continues walking to the next room.

>go east
You can't go that way.

Security is in Security Room. Security guard is heading

>go west
You can't go that way.

Security is in security checkpoint 2. Security guard is heading

>go south
Cell Room 2
The cells are on the northern side of the room. There's another cell room to the west and the security room is to east. The cafeteria is to the south.

You can see a rusted metal door and Joe here.

Security is in cafeteria. Security guard is heading

>z
Time passes.

Security is in security checkpoint 1. Security guard is heading

>open rusted metal door
It seems to be locked.

Security is in Storage Room. Security guard is heading

>examine rusted metal door
Enter six-digit code to unlock.

Security is in prison bathroom. Security guard is heading 
Please enter the six-digit locker pin code.

>112098
That's not a verb I recognise.

Please enter the six-digit locker pin code.

>enter 112098
You can't see any such thing.

Please enter the six-digit locker pin code.

>112098
That's not a verb I recognise.

Please enter the six-digit locker pin code.

>north
Joe's Cell
...

Security is in Cell Room 1. Security guard is heading 
Please enter the six-digit locker pin code.

>112098
That's not a verb I recognise.

Please enter the six-digit locker pin code.

>z
Time passes.

Security is in Cell Room 2. Security guard is heading 
The security guard continues walking to the next room.

Please enter the six-digit locker pin code.

>no
That was a rhetorical question.

Security is in Security Room. Security guard is heading 
Please enter the six-digit locker pin code.

>exit
But you aren't in anything at the moment.

Security is in security checkpoint 2. Security guard is heading 
Please enter the six-digit locker pin code.

>z
Time passes.

Security is in cafeteria. Security guard is heading 
Please enter the six-digit locker pin code.

>examine rusted metal door
You can't see any such thing.

Please enter the six-digit locker pin code.

* * *

>purloin key card
[Purloined.]

>s
Cell Room 1
The cells are on the northern side of the room. There's another cell room to the east.

The security guard is in security checkpoint 2 and is headed towards cafeteria.

>e
Cell Room 2
The cells are on the northern side of the room. There's another cell room to the west and the security room is to east. The cafeteria is to the south.

You can see a metal door and Joe here.

The security guard is in cafeteria and is headed towards security checkpoint 1.
You see Joe. He has been in this prison for 50 years, so he probably knows a lot about it. Try talking to him.

>x door
This door is headed south. Enter pin code to unlock the metal door.

The security guard is in security checkpoint 1 and is headed towards Storage Room.
You see Joe. He has been in this prison for 50 years, so he probably knows a lot about it. Try talking to him.

Please enter the pin code.

>963829
**BUZZ**  Access granted

>s
cafeteria
There's a cell room to the north, bathroom to the west, security checkpoint to the east, and another security checkpoint to the south.

You can see a metal door here.

The security guard is in Storage Room and is headed towards Prison Bathroom.

>z
Time passes.

The security guard is in Prison Bathroom and is headed towards Cell Room 1.

>s
    *** The guard sees you. You sprint towards the exit, but he grabs you before you can get away.  ***

Would you like to RESTART, RESTORE a saved game, QUIT or UNDO the last command?

>undo
cafeteria
[Previous turn undone.]

>z
Time passes.

The security guard is in Cell Room 1 and is headed towards Cell Room 2.

>e
    *** The guard sees you. You sprint towards the exit, but he grabs you before you can get away.  ***

Would you like to RESTART, RESTORE a saved game, QUIT or UNDO the last command?

>restart
You beg to the guard to let you free. "If you can't do the time, don't do the crime," he replies coldly. You'll go insane if you stay in prison any longer. Find a way to escape without being caught by the guard. Never be in the same room as him or he'll catch you. The only place you're safe from him is in the the cells.

Jail Break
An Interactive Fiction by tendo19
Release 1 / Serial number 190417 / Inform 7 build 6M62 (I6/v6.33 lib 6/12N) SD

your cell
You're in a small cramped space with a thin mattress and a filthy toilet. Hide here if the security guard comes. You notice that your cell is not fully locked. Go south to leave your cell.

>purloin key card
[Purloined.]

* * *

>e
    *** The guard sees you. You sprint towards the exit, but he grabs you before you can get away.  ***

Would you like to RESTART, RESTORE a saved game, QUIT or UNDO the last command?

>undo
cafeteria
[Previous turn undone.]

>w
Prison Bathroom
The cafeteria is to the east and the storage room is to the south.

You can see storage door here.

The security guard is in Cell Room 2 and is headed towards Security Room.

>s
(first opening storage door)
It seems to be locked.

The security guard is in Security Room and is headed towards security checkpoint 2.

>unlock door with key
You unlock storage door.

The security guard is in security checkpoint 2 and is headed towards cafeteria.

>s
(first opening storage door)

Storage Room
The bathroom is to the north and there's a security checkpoint to the east.

You can see storage door and Security Uniform here.

The security guard is in cafeteria and is headed towards security checkpoint 1.

* * *

>purloin plate
[Purloined.]

>break pkate
You can't see any such thing.

>break plate
Violence isn't the answer to this one.

The security guard is in security checkpoint 2 and is headed towards cafeteria.

* * *

>purloin plate
[Purloined.]

>break plate
Violence isn't the answer to this one.

The security guard is in security checkpoint 2 and is headed towards cafeteria.

>fuck
That's not a verb I recognise.

* * *

>purloin plate
[Purloined.]

>crack plate
Violence isn't the answer to this one.

The security guard is in security checkpoint 2 and is headed towards cafeteria.

>drop plate
You drop the plate, causing it to shatter. The janitor enters from the west and immediately starts cleaning the floor.

The security guard is in cafeteria and is headed towards security checkpoint 1.

>undo
your cell
[Previous turn undone.]

>shatter plate
You drop the plate, causing it to shatter. The janitor enters from the west and immediately starts cleaning the floor.

The security guard is in cafeteria and is headed towards security checkpoint 1.

>undo
your cell
[Previous turn undone.]

>crack plate
Violence isn't the answer to this one.

The security guard is in cafeteria and is headed towards security checkpoint 1.

>undo
your cell
[Previous turn undone.]

>break plate
Violence isn't the answer to this one.

The security guard is in cafeteria and is headed towards security checkpoint 1.

* * *

>purloin plate
[Purloined.]

>s
Cell Room 1
The cells are on the northern side of the room. There's another cell room to the east.

The security guard is in security checkpoint 2 and is headed towards cafeteria.

* * *

>s
cafeteria
There's a cell room to the north, bathroom to the west, security checkpoint to the east, and another security checkpoint to the south.

You can see a metal door here.

The security guard is in Storage Room and is headed towards Prison Bathroom.

>drop plate
Dropped.

The security guard is in Prison Bathroom and is headed towards Cell Room 1.

>take plate
Taken.

The security guard is in Cell Room 1 and is headed towards Cell Room 2.

>break plate
Violence isn't the answer to this one.

The security guard is in Cell Room 2 and is headed towards Security Room.

* * *

>s
cafeteria
There's a cell room to the north, bathroom to the west, security checkpoint to the east, and another security checkpoint to the south.

You can see a metal door here.

The security guard is in Storage Room and is headed towards Prison Bathroom.

>n
Cell Room 2
The cells are on the northern side of the room. There's another cell room to the west and the security room is to east. The cafeteria is to the south.

You can see a metal door and Joe here.

The security guard is in Prison Bathroom and is headed towards Cell Room 1.
You see Joe. He has been in this prison for 50 years, so he probably knows a lot about it. Try talking to him.

>s
cafeteria
There's a cell room to the north, bathroom to the west, security checkpoint to the east, and another security checkpoint to the south.

You can see a metal door here.

The security guard is in Cell Room 1 and is headed towards Cell Room 2.

>break plate
Violence isn't the answer to this one.

The security guard is in Cell Room 2 and is headed towards Security Room.

* * *

>purloin plate
[Purloined.]

>throw plate
Dropped.

The security guard is in security checkpoint 2 and is headed towards cafeteria.

>take plate
Taken.

The security guard is in cafeteria and is headed towards security checkpoint 1.

* * *

>restart
Are you sure you want to restart?

>yes
You beg to the guard to let you free. "If you can't do the time, don't do the crime," he replies coldly. You'll go insane if you stay in prison any longer. Find a way to escape without being caught by the guard. Never be in the same room as him or he'll catch you. The only place you're safe from is in the cell.

Jail Break
An Interactive Fiction by tendo19
Release 1 / Serial number 190409 / Inform 7 build 6M62 (I6/v6.33 lib 6/12N) SD

your cell
You're in a small cramped space with a thin mattress and a filthy toilet. You notice that your cell is not fully locked. Go south to leave your cell.

>s
Cell Room 1
The cells are on the northern side of the room. There's another cell room to the east and the bathroom is to the south.

You can see a metal door here.

The security guard is in security checkpoint 2 and is headed towards cafeteria.

I beg your pardon?

>z
Time passes.

The security guard is in cafeteria and is headed towards security checkpoint 1.

* * *

>z
Time passes.

The security guard is in Prison Bathroom and is headed towards Cell Room 1.

>z
Time passes.

The security guard is in Cell Room 1 and is headed towards Cell Room 2.

    *** The security guard sees you and chases you. You trip on a pebble and get caught. You have been moved to a higher security cell. Good luck escaping from there. ***

Would you like to RESTART, RESTORE a saved game, QUIT or UNDO the last command?

>restart
You beg to the guard to let you free. "If you can't do the time, don't do the crime," he replies coldly. You'll go insane if you stay in prison any longer. Find a way to escape without being caught by the guard. Never be in the same room as him or he'll catch you. The only place you're safe from is in the cell.

Jail Break
An Interactive Fiction by tendo19
Release 1 / Serial number 190409 / Inform 7 build 6M62 (I6/v6.33 lib 6/12N) SD

your cell
You're in a small cramped space with a thin mattress and a filthy toilet. You notice that your cell is not fully locked. Go south to leave your cell.

>e
You can't go that way.

The security guard is in security checkpoint 2 and is headed towards cafeteria.

>e
You can't go that way.

The security guard is in cafeteria and is headed towards security checkpoint 1.

>s
Cell Room 1
The cells are on the northern side of the room. There's another cell room to the east and the bathroom is to the south.

You can see a metal door here.

The security guard is in security checkpoint 1 and is headed towards Storage Room.

>e
Cell Room 2
The cells are on the northern side of the room. There's another cell room to the west and the security room is to east. The cafeteria is to the south.

You can see a rusted metal door and Joe here.

The security guard is in Storage Room and is headed towards Prison Bathroom.

>e
Security Room
There's cell room to the west and a security checkpoint to the south.

You can see Security camera monitor, a bulletin board (in which is a note) and Trash can (in which is Piece of paper) here.

The security guard is in Prison Bathroom and is headed towards Cell Room 1.

>s
security checkpoint 2
There's a security room to the north and the cafeteria to the west.

The security guard is in Cell Room 1 and is headed towards Cell Room 2.

>s
Freedom
You're free! Now you don't have to sleep next to your stinky cellmate.

    *** You win! ***

Would you like to RESTART, RESTORE a saved game, QUIT or UNDO the last command?

* * *

>rules on
Rules tracing now switched on. Type "rules off" to switch it off again, or "rules all" to include even rules which do not apply.

* * *

>rules off
[Rule "declare everything initially unmentioned rule" applies.]
Rules tracing now switched off. Type "rules" to switch it on again.

>s
You can't go that way.

>z
Time passes.

>z
Time passes.

* * *

>s
Cell Room 1
Your cell is on the northern side of the room. There's another cell room to the east.

The security guard is in security checkpoint 2 and is headed towards cafeteria.

>e
Cell Room 2
Joe's cell is on the northern side of the room. There's another cell room to the west and the security room is to east. The cafeteria is to the south.

You can see a metal door here.

The security guard is in cafeteria and is headed towards security checkpoint 1.

>e
Security Room
There's cell room to the west and a security checkpoint to the south. Don't go south unless you can sneak past the guard.

You can see Security camera monitor, a bulletin board (in which is a note) and Trash can (in which is Piece of paper) here.

The security guard is in security checkpoint 1 and is headed towards Storage Room.

>w
Cell Room 2
The cells are on the northern side of the room. There's another cell room to the west and the security room is to east. The cafeteria is to the south.

You can see a metal door and Joe here.

The security guard is in Storage Room and is headed towards Prison Bathroom.
You see Joe. He has been in this prison for 50 years, so he probably knows a lot about it. Try talking to him.

>n
Joe's Cell
Joe's room is a lot stinkier than your's. The smell is probably coming from his toilet. You're safe from the guard when you're in this room.

You can see Urinal (in which is a key card) here.

The security guard is in Prison Bathroom and is headed towards Cell Room 1.

>x urinal
Eww. I don't think he flushed the toilet. You also see a small card in it.

In Urinal is a key card.

The security guard is in Cell Room 1 and is headed towards Cell Room 2.

* * *

>e
Cell Room 2
Joe's cell is on the northern side of the room. There's another cell room to the west and the security room is to east. The cafeteria is to the south.

You can see a metal door here.

The security guard is in cafeteria and is headed towards security checkpoint 1.

>n
Joe's Cell
Joe's cell is a lot stinkier than your's. The smell is probably coming from his urinal. You're safe from the guard when you're in this room.

You can see Joe here.

The security guard is in security checkpoint 1 and is headed towards Storage Room. You see Joe. He has been in this prison for 50 years, so he probably knows a lot about it. Try talking to him.

>talk to joe
"Sup Joe," you say.

"What do you want?" he replies.

You can ask him about the prison layout or the security guards or the door.
The security guard is in Storage Room and is headed towards Prison Bathroom. You see Joe. He has been in this prison for 50 years, so he probably knows a lot about it. Try talking to him.

>talk to joe
"What?," he says.

 You can ask him about the prison layout or the security guards or the door.
The security guard is in Prison Bathroom and is headed towards Cell Room 1. You see Joe. He has been in this prison for 50 years, so he probably knows a lot about it. Try talking to him.

* * *

>n
Joe's Cell
Joe's cell is a lot stinkier than your's. The smell is probably coming from his urinal. You're safe from the guard when you're in this room.

You can see Joe here.

The security guard is in security checkpoint 1 and is headed towards Storage Room. You see Joe. He has been in this prison for 50 years, so he probably knows a lot about it. Try talking to him.

>z
Time passes.

Security guard heads to Storage Room.

>z
Time passes.

Security guard heads to prison bathroom.

>z
Time passes.

Security guard heads to Cell Room 1.

>z
Time passes.

Security guard heads to Cell Room 2.

The security guard continues walking to the next room.

>z
Time passes.

Security guard heads to Security Room.

>z
Time passes.

Security guard heads to security checkpoint 2.

>z
Time passes.

Security guard heads to cafeteria.

>z
Time passes.

Security guard heads to security checkpoint 1.

>z
Time passes.

Security guard heads to Storage Room.

* * *

>z
Time passes.

Security guard heads to Cell Room 1.

>z
Time passes.

Security guard heads to Cell Room 2.

* * *

>e
Cell Room 2
Joe's cell is on the northern side of the room. There's another cell room to the west and the security room is to east. The cafeteria is to the south.

You can see a metal door here.

The security guard is in cafeteria and is headed towards security checkpoint 1.

>talk to joe
"Sup Joe," you say.

"What do you want?" he replies.

You can ask him about the prison layout or the security guards or the door.
The security guard is in security checkpoint 1 and is headed towards Storage Room. You see Joe. He has been in this prison for 50 years, so he probably knows a lot about it. Try talking to him.

>ask him about the guards
There are three security guards in this prison. The first one walks around the prison. You should avoid being in the same room as him. He always takes same route, so you should be able to figure where he's headed.

One of them is guarding security checkpoint 1 and the last one is guarding security checkpoint 2. You need to find a way to sneak past all three of them if you want to escape. Whatever you do, don't make any noise.

The only place you're truly safe is in the cells. If the guard comes, just go into one of the cells and don't act suspicious.

The security guard is in Storage Room and is headed towards Prison Bathroom.
You see Joe. He has been in this prison for 50 years, so he probably knows a lot about it. Try talking to him.

* * *

>talk to joe
"Sup Joe," you say.

"What do you want?" he replies.

You can ask him about the prison layout or the security guards or the door.
The security guard is in security checkpoint 1 and is headed towards Storage Room. You see Joe. He has been in this prison for 50 years, so he probably knows a lot about it. Try talking to him.

>ask him about the prison layout
There are eight rooms and two exits. If you want to leave, you'll have to go through one of the security checkpoints, but be careful because there are guards there.You need some kind of disguise to sneak past them.

The security guard is in Storage Room and is headed towards Prison Bathroom. You see Joe. He has been in this prison for 50 years, so he probably knows a lot about it. Try talking to him.

>ask him about the security guards
There are three security guards in this prison. The first one walks around the prison. You should avoid being in the same room as him. He always takes same route, so you should be able to figure where he's headed.

One of them is guarding security checkpoint 1 and the last one is guarding security checkpoint 2. You need to find a way to sneak past all three of them if you want to escape. Whatever you do, don't make any noise.

The only place you're truly safe is in the cells. If the guard comes, just go into one of the cells and don't act suspicious.

The security guard is in Prison Bathroom and is headed towards Cell Room 1. You see Joe. He has been in this prison for 50 years, so he probably knows a lot about it. Try talking to him.
The guard is coming! Hide in my cell!

* * *

>talk to joe
"Sup Joe," you say.

"What do you want?" he replies.

You can ask him about the prison layout or the security guards or the door.
The security guard is in security checkpoint 1 and is headed towards Storage Room. You see Joe. He has been in this prison for 50 years, so he probably knows a lot about it. Try talking to him.

>ask him about the security guards
There are three security guards in this prison. The first one walks around the prison. You should avoid being in the same room as him. He always takes same route, so you should be able to figure where he's headed.

One of them is guarding security checkpoint 1 and the last one is guarding security checkpoint 2. You need to find a way to sneak past all three of them if you want to escape. Whatever you do, don't make any noise.

The only place you're truly safe is in the cells. If the guard comes, just go into one of the cells and don't act suspicious.

The security guard is in Storage Room and is headed towards Prison Bathroom.

* * *

>talk to joe
"Sup Joe," you say.

"What do you want?" he replies.

You can ask him about the prison layout or the security guards or the door.
The security guard is in security checkpoint 1 and is headed towards Storage Room. You see Joe. He has been in this prison for 50 years, so he probably knows a lot about it. Try talking to him.

>ask joe about the prison layout
Hi.

The security guard is in Storage Room and is headed towards Prison Bathroom.

* * *

>talk to joe
"Sup Joe," you say.

"What do you want?" he replies.

You can ask him about the prison layout or the security guards or the door.
The security guard is in security checkpoint 1 and is headed towards Storage Room. You see Joe. He has been in this prison for 50 years, so he probably knows a lot about it. Try talking to him.

>talk to him
Hi there!

The security guard is in Storage Room and is headed towards Prison Bathroom.

* * *

>talk to joe
"Sup Joe," you say.

"What do you want?" he replies.

You can ask him about the prison layout or the security guards or the door.
The security guard is in security checkpoint 1 and is headed towards Storage Room. You see Joe. He has been in this prison for 50 years, so he probably knows a lot about it. Try talking to him.

>talk to the joe
"How can I escape this place?" you ask.

"This prison is quite complex. You need to reach one of the security checkpoints without being caught," he replies. 

 You say, "Is there any way to sneak past the guards?"

"Whatever you do, don't be in the same room as the security guard. He always takes the same path so you should be able to figure out where he is."

The security guard is in Storage Room and is headed towards Prison Bathroom.

* * *

>e
Cell Room 2
Joe's cell is on the northern side of the room. There's another cell room to the west and the security room is to east. The cafeteria is to the south.

You can see a metal door here.

The security guard is in cafeteria and is headed towards security checkpoint 1.

>talk to the joe
"Sup Joe," you say.

"What do you want?" he replies.

You can ask him about the prison layout or the security guards.
The security guard is in security checkpoint 1 and is headed towards Storage Room.

>ask him about the prison layout
There is no reply.

The security guard is in Storage Room and is headed towards Prison Bathroom.

>ask joe about the prison layout
There is no reply.

The security guard is in Prison Bathroom and is headed towards Cell Room 1.

>n
Joe's Cell
...

The security guard is in Cell Room 1 and is headed towards Cell Room 2.

>z
Time passes.

You see the security guard heading to the next room.
The security guard is in Cell Room 2 and is headed towards Security Room.

>s
Cell Room 2
The cells are on the northern side of the room. There's another cell room to the west and the security room is to east. The cafeteria is to the south.

You can see a rusted metal door and Joe here.

The security guard is in Security Room and is headed towards security checkpoint 2.

>talk to joe
You must supply a noun.

The security guard is in security checkpoint 2 and is headed towards cafeteria.

>talk to the joe
"Sup Joe," you say.

"What do you want?" he replies.

You can ask him about the prison layout or the security guards.
The security guard is in cafeteria and is headed towards security checkpoint 1.

>ask the joe about the prison layout
There is no reply.

The security guard is in security checkpoint 1 and is headed towards Storage Room.

>ask the joe about security guards
Yo.

The security guard is in Storage Room and is headed towards Prison Bathroom.

* * *

>talk to the joe
"Sup Joe," you say.

"What do you want?" he replies.

You can ask him about the prison layout or the security guards.
The security guard is in security checkpoint 1 and is headed towards Storage Room.

>restart
Are you sure you want to restart?

>yes
You beg to the guard to let you free. "If you can't do the time, don't do the crime," he replies coldly. You'll go insane if you stay in prison any longer. Find a way to escape without being caught by the guard. Never be in the same room as him or he'll catch you. The only place you're safe from is in the cell.

Jail Break
An Interactive Fiction by tendo19
Release 1 / Serial number 190411 / Inform 7 build 6M62 (I6/v6.33 lib 6/12N) SD

your cell
You're in a small cramped space with a thin mattress and a filthy toilet. You notice that your cell is not fully locked. Go south to leave your cell.

>s
Cell Room 1
The cells are on the northern side of the room. There's another cell room to the east and the bathroom is to the south.

You can see a metal door here.

The security guard is in security checkpoint 2 and is headed towards cafeteria.

>e
Cell Room 2
The cells are on the northern side of the room. There's another cell room to the west and the security room is to east. The cafeteria is to the south.

You can see a rusted metal door and Joe here.

The security guard is in cafeteria and is headed towards security checkpoint 1.

>talk to joe
You must supply a noun.

The security guard is in security checkpoint 1 and is headed towards Storage Room.

* * *

>e
Cell Room 2
Joe's cell is on the northern side of the room. There's another cell room to the west and the security room is to east. The cafeteria is to the south.

You can see a metal door here.

The security guard is in cafeteria and is headed towards security checkpoint 1.

>w
Cell Room 1
Your cell is on the northern side of the room. There's another cell room to the east.

The security guard is in security checkpoint 1 and is headed towards Storage Room.

>e
Cell Room 2
The cells are on the northern side of the room. There's another cell room to the west and the security room is to east. The cafeteria is to the south.

You can see a metal door and Joe here.

The security guard is in Storage Room and is headed towards Prison Bathroom.

* * *

>e
Cell Room 2
Joe's cell is on the northern side of the room. There's another cell room to the west and the security room is to east. The cafeteria is to the south.

You can see a metal door here.

The security guard is in cafeteria and is headed towards security checkpoint 1.

>x door
This door is headed south. Enter pin code to unlock the metal door.

The security guard is in security checkpoint 1 and is headed towards Storage Room.
Please enter the pin code.

>928369
**BUZZ**  Access granted

>open door
It seems to be locked.

The security guard is in Storage Room and is headed towards prison bathroom.

>w
Cell Room 1
The cells are on the northern side of the room.There's another cell room to the east and the bathroom is to the south.

You can see a metal door here.

The security guard is in prison bathroom and is headed towards Cell Room 1.

>n
your cell
You're in a small cramped space with a thin mattress and a filthy toilet. You notice that your cell is not fully locked. Go south to leave your cell. 

You see the security guard walking to the next room.
The security guard is in Cell Room 1 and is headed towards Cell Room 2.

* * *

>x door
This door is headed south. Enter pin code to unlock the metal door.

The security guard is in security checkpoint 1 and is headed towards Storage Room.
Please enter the pin code.

>963829
**BUZZ**  Access granted. Door leads to the south.

>s
cafeteria
The cafeteria is empty. There's a cell room to the north, bathroom to the west, security checkpoint to the east, and another security checkpoint to the south. Don't go east or south unless you can sneak past the guard.

You can see a metal door and Ceramic plate here.

The security guard is in Storage Room and is headed towards Prison Bathroom.

>take plate
Taken.

The security guard is in Prison Bathroom and is headed towards Cell Room 1.

>drop plate
You drop the plate, causing it to shatter. The janitor enters from the west and immediately starts cleaning the floor.

The security guard is in Cell Room 1 and is headed towards Cell Room 2.

>w
Prison Bathroom
You see a sign next to a door. There really isn't anything to do in the bathroom. The cafeteria is to the east and the storage room is to the south.

You can see storage door, Sign and a urinal here.

The security guard is in Cell Room 2 and is headed towards Security Room.

>s
(first opening storage door)

Storage Room
The bathroom is to the north and there's a security checkpoint to the east. The room is quite empty. Don't go east unless you can sneak past the guard.

You can see storage door and Security Uniform here.

The security guard is in Security Room and is headed towards security checkpoint 2.

>take uniform
Taken.

The security guard is in security checkpoint 2 and is headed towards cafeteria.

>wear uniform
You put on Security Uniform.

The security guard is in cafeteria and is headed towards security checkpoint 1.

>e
Act natural, the exit is right in front of you!

He walks right past you without taking a second glance.
He walks right past you without taking a second glance.
The security guard is in security checkpoint 1 and is headed towards Storage Room.

>e
Freedom
You're free!

The security guard is in Storage Room and is headed towards Prison Bathroom.

    *** You win!! Now go back home and stay out of trouble. ***

Would you like to RESTART, RESTORE a saved game, QUIT or UNDO the last command?

* * *

>s
(first opening storage door)

Storage Room
The bathroom is to the north and there's a security checkpoint to the east. The room is quite empty. Don't go east unless you can sneak past the guard.

You can see storage door and Security Uniform here.

The security guard is in Security Room and is headed towards security checkpoint 2.

>wear uniform
(first taking Security Uniform)
You put on Security Uniform.

The security guard is in security checkpoint 2 and is headed towards cafeteria.

>n
Prison Bathroom
You see a sign next to a door. There really isn't anything to do in the bathroom. The cafeteria is to the east and the storage room is to the south.

You can see storage door, Sign and a urinal here.

The security guard is in cafeteria and is headed towards security checkpoint 1.

>s
Storage Room
The bathroom is to the north and there's a security checkpoint to the east. The room is quite empty. Don't go east unless you can sneak past the guard.

You can see storage door here.

The security guard is in security checkpoint 1 and is headed towards Storage Room.

>z
Time passes.

He walks right past you without taking a second glance.
He walks right past you without taking a second glance.
The security guard is in Storage Room and is headed towards Prison Bathroom.

* * *

>take plate
Taken.

The security guard is in Prison Bathroom and is headed towards Cell Room 1.

>w
Prison Bathroom
There's nothing much to do here. The cafeteria is to the east and the storage room is to the south.

You can see storage door here.

The security guard is in Cell Room 1 and is headed towards Cell Room 2.

* * *

>s
cafeteria
The cafeteria is empty. There's a cell room to the north, bathroom to the west, security checkpoint to the east, and another security checkpoint to the south. Don't go east or south unless you can sneak past the guard.

You can see a metal door and Ceramic plate here.

The security guard is in Storage Room and is headed towards Prison Bathroom.

>w
Prison Bathroom
There's nothing much to do here. The cafeteria is to the east and the storage room is to the south.

You can see storage door, a security guard and a urinal here.

The security guard is in Prison Bathroom and is headed towards Cell Room 1.

    *** The security guard sees you and chases you. You trip on a pebble and get caught. You have been moved to a higher security cell. Good luck escaping from there. ***

Would you like to RESTART, RESTORE a saved game, QUIT or UNDO the last command?

>undo
cafeteria
[Previous turn undone.]

>take plate
Taken.

The security guard is in Prison Bathroom and is headed towards Cell Room 1.

* * *

>drop plate
You drop the plate, causing it to shatter. The janitor enters from the west and immediately starts cleaning the floor.

The security guard is in Cell Room 1 and is headed towards Cell Room 2.

>w
Prison Bathroom
There's nothing much to do here. The cafeteria is to the east and the storage room is to the south.

You can see storage door and a urinal here.

The security guard is in Cell Room 2 and is headed towards Security Room.

>s
(first opening storage door)

Storage Room
The bathroom is to the north and there's a security checkpoint to the east. The room is quite empty. Don't go east unless you can sneak past the guard.

You can see storage door and Security Uniform here.

The security guard is in Security Room and is headed towards security checkpoint 2.

* * *

>e
Cell Room 2
Joe's cell is on the northern side of the room. There's another cell room to the west and the security room is to east. The cafeteria is to the south.

You can see a metal door here.

The security guard is in cafeteria and is headed towards security checkpoint 1.

>x metal door
This door is headed south. Enter pin code to unlock the metal door.

The security guard is in security checkpoint 1 and is headed towards Storage Room.
You see Joe. He has been in this prison for 50 years, so he probably knows a lot about it. Try talking to him.

Please enter the pin code.

>n
Incorrect pin code, door remains locked.

Would you like to try again? (Yes or No)

* * *

>talk to Joe
"Sup Joe," you say.

"What do you want?" he replies.

You can ask him about the prison layout or the security guards or the door.
The security guard is in Storage Room and is headed towards Prison Bathroom.
You see Joe. He has been in this prison for 50 years, so he probably knows a lot about it. Try talking to him.

>talk to Joe about the door
I only understood you as far as wanting to talk to Joe.

>ask Joe about the door
If you  examine the door closely, you'll see that you need a pincode to unlock the door. The security room is east from here, so maybe you be able to find some clues there.

The security guard is in Prison Bathroom and is headed towards Cell Room 1.
You see Joe. He has been in this prison for 50 years, so he probably knows a lot about it. Try talking to him.

>n
Joe's Cell
Joe's room is a lot stinkier than your's. The smell is probably coming from his toilet. You're safe from the guard when you're in this room.

You can see Urinal (in which is a key card) here.

The security guard is in Cell Room 1 and is headed towards Cell Room 2.

>x urinal
Eww. I don't think he flushed the toilet. You also see a small card in it.

In Urinal is a key card.

You see the security guard heading to the next room.
The security guard is in Cell Room 2 and is headed towards Security Room.

>take key card
Taken.

The security guard is in Security Room and is headed towards security checkpoint 2.

>s
Cell Room 2
The cells are on the northern side of the room. There's another cell room to the west and the security room is to east. The cafeteria is to the south.

You can see a metal door and Joe here.

The security guard is in security checkpoint 2 and is headed towards cafeteria.
You see Joe. He has been in this prison for 50 years, so he probably knows a lot about it. Try talking to him.

>w
Cell Room 1
The cells are on the northern side of the room. There's another cell room to the east.

The security guard is in cafeteria and is headed towards security checkpoint 1.

>e
Cell Room 2
The cells are on the northern side of the room. There's another cell room to the west and the security room is to east. The cafeteria is to the south.

You can see a metal door and Joe here.

The security guard is in security checkpoint 1 and is headed towards Storage Room.
You see Joe. He has been in this prison for 50 years, so he probably knows a lot about it. Try talking to him.

>e
Security Room
There's cell room to the west and a security checkpoint to the south. Don't go south unless you can sneak past the guard.

You can see Security camera monitor, a bulletin board (in which is a note) and Trash can (in which is Piece of paper) here.

The security guard is in Storage Room and is headed towards Prison Bathroom.

>x bulletin board
It has a single piece of paper pinned on it.

In the bulletin board is a note.

The security guard is in Prison Bathroom and is headed towards Cell Room 1.

>x note
It reads: Door Pin Code: 9283 . . . a piece of the paper is missing. There's also an arrow pointing from right to left. What could the last two digits be?

The security guard is in Cell Room 1 and is headed towards Cell Room 2.

>x trash can
There's a rubberband, a gum, and a tiny piece of paper.

In Trash can is Piece of paper.

The security guard is in Cell Room 2 and is headed towards Security Room.

>s
    *** The guard sees you. You sprint towards the exit, but he grabs you before you can get away.  ***

Would you like to RESTART, RESTORE a saved game, QUIT or UNDO the last command?

* * *

>undo
Security Room
[Previous turn undone.]

>undo
Security Room
[Previous turn undone.]

>w
Cell Room 2
The cells are on the northern side of the room. There's another cell room to the west and the security room is to east. The cafeteria is to the south.

You can see a metal door and Joe here.

The security guard is in Cell Room 1 and is headed towards Cell Room 2.
You see Joe. He has been in this prison for 50 years, so he probably knows a lot about it. Try talking to him.

>n
Joe's Cell
Joe's room is a lot stinkier than your's. The smell is probably coming from his toilet. You're safe from the guard when you're in this room.

You can see Urinal (empty) here.

You see the security guard heading to the next room.
The security guard is in Cell Room 2 and is headed towards Security Room.

>s
Cell Room 2
The cells are on the northern side of the room. There's another cell room to the west and the security room is to east. The cafeteria is to the south.

You can see a metal door and Joe here.

The security guard is in Security Room and is headed towards security checkpoint 2.
You see Joe. He has been in this prison for 50 years, so he probably knows a lot about it. Try talking to him.

>talk to Joe
"Sup Joe," you say.

"What do you want?" he replies.

You can ask him about the prison layout or the security guards or the door.
The security guard is in security checkpoint 2 and is headed towards cafeteria.
You see Joe. He has been in this prison for 50 years, so he probably knows a lot about it. Try talking to him.

>ask about prison layout
You can't see any such thing.

>ask Joe about the prison layout
There are eight rooms and two exits. If you want to leave, you'll have to go through one of the security checkpoints, but be careful because there are guards there.You need some kind of disguise to sneak past them.

The security guard is in cafeteria and is headed towards security checkpoint 1.
You see Joe. He has been in this prison for 50 years, so he probably knows a lot about it. Try talking to him.

>ask Joe about door
If you  examine the door closely, you'll see that you need a pincode to unlock the door. The security room is east from here, so maybe you be able to find some clues there.

The security guard is in security checkpoint 1 and is headed towards Storage Room.
You see Joe. He has been in this prison for 50 years, so he probably knows a lot about it. Try talking to him.

>s
(first opening the metal door)
It seems to be locked.

The security guard is in Storage Room and is headed towards Prison Bathroom.
You see Joe. He has been in this prison for 50 years, so he probably knows a lot about it. Try talking to him.

>n
Joe's Cell
Joe's room is a lot stinkier than your's. The smell is probably coming from his toilet. You're safe from the guard when you're in this room.

You can see Urinal (empty) here.

The security guard is in Prison Bathroom and is headed towards Cell Room 1.

>e
You can't go that way.

The security guard is in Cell Room 1 and is headed towards Cell Room 2.

>n
You can't go that way.

You see the security guard heading to the next room.
The security guard is in Cell Room 2 and is headed towards Security Room.

>s
Cell Room 2
The cells are on the northern side of the room. There's another cell room to the west and the security room is to east. The cafeteria is to the south.

You can see a metal door and Joe here.

The security guard is in Security Room and is headed towards security checkpoint 2.
You see Joe. He has been in this prison for 50 years, so he probably knows a lot about it. Try talking to him.

>x door
This door is headed south. Enter pin code to unlock the metal door.

The security guard is in security checkpoint 2 and is headed towards cafeteria.
You see Joe. He has been in this prison for 50 years, so he probably knows a lot about it. Try talking to him.

Please enter the pin code.

>9283
Incorrect pin code, door remains locked.

Would you like to try again? (Yes or No)

* * *

>e
Security Room
There's cell room to the west and a security checkpoint to the south. Don't go south unless you can sneak past the guard.

You can see Security camera monitor, a bulletin board (in which is a note) and Trash can (in which is Piece of paper) here.

The security guard is in cafeteria and is headed towards security checkpoint 1.

>x trash can
There's a rubberband, a gum, and a tiny piece of paper.

In Trash can is Piece of paper.

The security guard is in security checkpoint 1 and is headed towards Storage Room.

>x piece of paper
There's a number written on it. It is the number 69.

The security guard is in Storage Room and is headed towards Prison Bathroom.

>s
    *** The guard sees you. You sprint towards the exit, but he grabs you before you can get away.  ***

Would you like to RESTART, RESTORE a saved game, QUIT or UNDO the last command?

* * *

>undo
Security Room
[Previous turn undone.]

>w
Cell Room 2
The cells are on the northern side of the room. There's another cell room to the west and the security room is to east. The cafeteria is to the south.

You can see a metal door and Joe here.

The security guard is in Prison Bathroom and is headed towards Cell Room 1.
You see Joe. He has been in this prison for 50 years, so he probably knows a lot about it. Try talking to him.

>n
Joe's Cell
Joe's room is a lot stinkier than your's. The smell is probably coming from his toilet. You're safe from the guard when you're in this room.

You can see Urinal (empty) here.

The security guard is in Cell Room 1 and is headed towards Cell Room 2.

>z
Time passes.

You see the security guard heading to the next room.
The security guard is in Cell Room 2 and is headed towards Security Room.

>s
Cell Room 2
The cells are on the northern side of the room. There's another cell room to the west and the security room is to east. The cafeteria is to the south.

You can see a metal door and Joe here.

The security guard is in Security Room and is headed towards security checkpoint 2.
You see Joe. He has been in this prison for 50 years, so he probably knows a lot about it. Try talking to him.

* * *

>talk to Joe
"Sup Joe," you say.

"What do you want?" he replies.

You can ask him about the prison layout or the security guards or the door.
The security guard is in security checkpoint 2 and is headed towards cafeteria.
You see Joe. He has been in this prison for 50 years, so he probably knows a lot about it. Try talking to him.

>x door
This door is headed south. Enter pin code to unlock the metal door.

The security guard is in cafeteria and is headed towards security checkpoint 1.
You see Joe. He has been in this prison for 50 years, so he probably knows a lot about it. Try talking to him.

Please enter the pin code.

>928369
Incorrect pin code, door remains locked.

Would you like to try again? (Yes or No)

>e
Would you like to try again? (Yes or No)

* * *

>e
Security Room
There's cell room to the west and a security checkpoint to the south. Don't go south unless you can sneak past the guard.

You can see Security camera monitor, a bulletin board (in which is a note) and Trash can (in which is Piece of paper) here.

The security guard is in security checkpoint 1 and is headed towards Storage Room.

>x bulletin board
It has a single piece of paper pinned on it.

In the bulletin board is a note.

The security guard is in Storage Room and is headed towards Prison Bathroom.

>x note
It reads: Door Pin Code: 9283 . . . a piece of the paper is missing. There's also an arrow pointing from right to left. What could the last two digits be?

The security guard is in Prison Bathroom and is headed towards Cell Room 1.

>w
Cell Room 2
The cells are on the northern side of the room. There's another cell room to the west and the security room is to east. The cafeteria is to the south.

You can see a metal door and Joe here.

The security guard is in Cell Room 1 and is headed towards Cell Room 2.
You see Joe. He has been in this prison for 50 years, so he probably knows a lot about it. Try talking to him.

* * *

>n
Joe's Cell
Joe's room is a lot stinkier than your's. The smell is probably coming from his toilet. You're safe from the guard when you're in this room.

You can see Urinal (empty) here.

You see the security guard heading to the next room.
The security guard is in Cell Room 2 and is headed towards Security Room.

>z
Time passes.

The security guard is in Security Room and is headed towards security checkpoint 2.

>e
You can't go that way.

The security guard is in security checkpoint 2 and is headed towards cafeteria.

>s
Cell Room 2
The cells are on the northern side of the room. There's another cell room to the west and the security room is to east. The cafeteria is to the south.

You can see a metal door and Joe here.

The security guard is in cafeteria and is headed towards security checkpoint 1.
You see Joe. He has been in this prison for 50 years, so he probably knows a lot about it. Try talking to him.

>e
Security Room
There's cell room to the west and a security checkpoint to the south. Don't go south unless you can sneak past the guard.

You can see Security camera monitor, a bulletin board (in which is a note) and Trash can (in which is Piece of paper) here.

The security guard is in security checkpoint 1 and is headed towards Storage Room.

* * *

>w
Cell Room 2
The cells are on the northern side of the room. There's another cell room to the west and the security room is to east. The cafeteria is to the south.

You can see a metal door and Joe here.

The security guard is in Storage Room and is headed towards Prison Bathroom.
You see Joe. He has been in this prison for 50 years, so he probably knows a lot about it. Try talking to him.

>x door
This door is headed south. Enter pin code to unlock the metal door.

The security guard is in Prison Bathroom and is headed towards Cell Room 1.
You see Joe. He has been in this prison for 50 years, so he probably knows a lot about it. Try talking to him.

Please enter the pin code.

>963829
**BUZZ**  Access granted

>n
Joe's Cell
Joe's room is a lot stinkier than your's. The smell is probably coming from his toilet. You're safe from the guard when you're in this room.

You can see Urinal (empty) here.

The security guard is in Cell Room 1 and is headed towards Cell Room 2.

* * *

>s
Cell Room 2
The cells are on the northern side of the room. There's another cell room to the west and the security room is to east. The cafeteria is to the south.

You can see a metal door and Joe here.

The security guard is in Security Room and is headed towards security checkpoint 2.
You see Joe. He has been in this prison for 50 years, so he probably knows a lot about it. Try talking to him.

>s
cafeteria
There's a cell room to the north, bathroom to the west, security checkpoint to the east, and another security checkpoint to the south. Don't go east or south unless you can sneak past the guard.

You can see a metal door here.

The security guard is in security checkpoint 2 and is headed towards cafeteria.

>n
Cell Room 2
The cells are on the northern side of the room. There's another cell room to the west and the security room is to east. The cafeteria is to the south.

You can see a metal door and Joe here.

The security guard is in cafeteria and is headed towards security checkpoint 1.
You see Joe. He has been in this prison for 50 years, so he probably knows a lot about it. Try talking to him.

>s
cafeteria
There's a cell room to the north, bathroom to the west, security checkpoint to the east, and another security checkpoint to the south. Don't go east or south unless you can sneak past the guard.

You can see a metal door here.

The security guard is in security checkpoint 1 and is headed towards Storage Room.

>w
Prison Bathroom
The cafeteria is to the east and the storage room is to the south.

You can see storage door here.

The security guard is in Storage Room and is headed towards Prison Bathroom.

>e
cafeteria
There's a cell room to the north, bathroom to the west, security checkpoint to the east, and another security checkpoint to the south. Don't go east or south unless you can sneak past the guard.

You can see a metal door here.

The security guard is in Prison Bathroom and is headed towards Cell Room 1.

>w
Prison Bathroom
The cafeteria is to the east and the storage room is to the south.

You can see storage door here.

The security guard is in Cell Room 1 and is headed towards Cell Room 2.

>x storage
You need a key card to access this room.

The security guard is in Cell Room 2 and is headed towards Security Room.

>insert key card
(in the key card)
You can't put something inside itself.

The security guard is in Security Room and is headed towards security checkpoint 2.

>use key card
That's not a verb I recognise.

>unlock door with keycard
You unlock storage door.

The security guard is in security checkpoint 2 and is headed towards cafeteria.

>s
(first opening storage door)

Storage Room
The bathroom is to the north and there's a security checkpoint to the east. Don't go east unless you can sneak past the guard.

You can see storage door and Security Uniform here.

The security guard is in cafeteria and is headed towards security checkpoint 1.

>take security uniform
Taken.

The security guard is in security checkpoint 1 and is headed towards Storage Room.

>n
Prison Bathroom
The cafeteria is to the east and the storage room is to the south.

You can see storage door here.

The security guard is in Storage Room and is headed towards Prison Bathroom.

>wear uniform
You put on Security Uniform.

The security guard is in Prison Bathroom and is headed towards Cell Room 1.

>s
Storage Room
The bathroom is to the north and there's a security checkpoint to the east. Don't go east unless you can sneak past the guard.

You can see storage door here.

The security guard is in Cell Room 1 and is headed towards Cell Room 2.

>n
Prison Bathroom
The cafeteria is to the east and the storage room is to the south.

You can see storage door here.

The security guard is in Cell Room 2 and is headed towards Security Room.

>n
You can't go that way.

The security guard is in Security Room and is headed towards security checkpoint 2.

>e
cafeteria
There's a cell room to the north, bathroom to the west, security checkpoint to the east, and another security checkpoint to the south. Don't go east or south unless you can sneak past the guard.

You can see a metal door here.

The security guard is in security checkpoint 2 and is headed towards cafeteria.

>s
Act natural, the exit is right in front of you!

The security guard is in cafeteria and is headed towards security checkpoint 1.

>e
Freedom
You're free!

The security guard is in security checkpoint 1 and is headed towards Storage Room.

    *** You're free! Now go back home and stay out of trouble. ***

Would you like to RESTART, RESTORE a saved game, QUIT or UNDO the last command?

* * *

>e
Cell Room 2
Joe's cell is on the northern side of the room. There's another cell room to the west and the security room is to east. The cafeteria is to the south.

You can see a metal door here.

The security guard is in cafeteria and is headed towards security checkpoint 1.

>x rusted metal door
Please enter the six-digit pin code to unlock it.

The security guard is in security checkpoint 1 and is headed towards Storage Room.

Please enter the six-digit pin code.

>112098
**BUZZ**  Access granted

>open door
It seems to be locked.

The security guard is in Storage Room and is headed towards prison bathroom.

>s
(first opening the rusted metal door)
It seems to be locked.

The security guard is in prison bathroom and is headed towards Cell Room 1.

>unlock door
What do you want to unlock the rusted metal door with?

>x door
Please enter the six-digit pin code to unlock it.

The security guard is in Cell Room 1 and is headed towards Cell Room 2.

    *** The security guard sees you and chases you. You trip on a pebble and get caught. You have been moved to a higher security cell. Good luck escaping from there. ***

Would you like to RESTART, RESTORE a saved game, QUIT or UNDO the last command?

>restart
You beg to the guard to let you free. "If you can't do the time, don't do the crime," he replies coldly. You'll go insane if you stay in prison any longer. Find a way to escape without being caught by the guard by never being in the same room as him. The only place you're safe from is in the cell.

Jail Break
An Interactive Fiction by tendo19
Release 1 / Serial number 190405 / Inform 7 build 6M62 (I6/v6.33 lib 6/12N) SD

your cell
You're in a small cramped space with a think mattress and a filthy toilet. You notice that your cell is not fully locked. Go south to leave your cell.

>z
Time passes.

The security guard is in security checkpoint 2 and is headed towards cafeteria.

>z
Time passes.

The security guard is in cafeteria and is headed towards security checkpoint 1.

* * *

>z
Time passes.

The security guard is in Storage Room and is headed towards prison bathroom.

>z
Time passes.

The security guard is in prison bathroom and is headed towards Cell Room 1.
You see the security guard walking to the next room.

>s
Cell Room 1
The cells are on the northern side of the room.There's another cell room to the east and the bathroom is to the south.

You can see a security guard and a metal door here.

The security guard is in Cell Room 1 and is headed towards Cell Room 2.

>w
You can't go that way.

The security guard is in Cell Room 2 and is headed towards security checkpoint 2.

>e
Cell Room 2
The cells are on the northern side of the room. There's another cell room to the west and the security room is to east. The cafeteria is to the south.

You can see a rusted metal door and Joe here.

The security guard is in security checkpoint 2 and is headed towards cafeteria.

>x rusted metal door
Please enter the six-digit pin code to unlock it.

The security guard is in cafeteria and is headed towards security checkpoint 1.

Please enter the six-digit pin code.

>112098
**BUZZ**  Access granted

>open door
It seems to be locked.

The security guard is in security checkpoint 1 and is headed towards Storage Room.

* * *

>e
Cell Room 2
Joe's cell is on the northern side of the room. There's another cell room to the west and the security room is to east. The cafeteria is to the south.

You can see a metal door here.

The security guard is in cafeteria and is headed towards security checkpoint 1.

>z
Time passes.

The security guard is in security checkpoint 1 and is headed towards Storage Room.

* * *

>z
Time passes.

The security guard is in Prison Bathroom and is headed towards Cell Room 1.

>z
Time passes.

The security guard is in Cell Room 1 and is headed towards Cell Room 2. Joe says "The guard is coming! Hide in my cell!"

>n
Joe's Cell
Joe's cell is a lot stinkier than your's. The smell is probably coming from his urinal. You're safe from the guard when you're in this room.

You can see Joe here.

You see the security guard heading to the next room.
The security guard is in Cell Room 2 and is headed towards Security Room. You see Joe. He has been in this prison for 50 years, so he probably knows a lot about it. Try talking to him.

>s
Cell Room 2
Joe's cell is on the northern side of the room. There's another cell room to the west and the security room is to east. The cafeteria is to the south.

You can see a metal door here.

The security guard is in Security Room and is headed towards security checkpoint 2.

* * *

>s
Cell Room 1
Your cell is on the northern side of the room. There's another cell room to the east.

The security guard is in security checkpoint 2 and is headed towards cafeteria.

>n
your cell
You're in a small cramped space with a thin mattress and a filthy toilet. Hide here if the security guard comes. You notice that your cell is not fully locked. Go south to leave your cell. 

The security guard is in cafeteria and is headed towards security checkpoint 1.

>s
Cell Room 1
The cells are on the northern side of the room. There's another cell room to the east.

The security guard is in security checkpoint 1 and is headed towards Storage Room.

>1
That's not a verb I recognise.

>n
your cell
You're in a small cramped space with a thin mattress and a filthy toilet. Hide here if the security guard comes. You notice that your cell is not fully locked. Go south to leave your cell. 

The security guard is in Storage Room and is headed towards Prison Bathroom.

>explore
That's not a verb I recognise.

>s
Cell Room 1
The cells are on the northern side of the room. There's another cell room to the east.

The security guard is in Prison Bathroom and is headed towards Cell Room 1.

>n
your cell
You're in a small cramped space with a thin mattress and a filthy toilet. Hide here if the security guard comes. You notice that your cell is not fully locked. Go south to leave your cell. 

You see the security guard heading to the next room.
The security guard is in Cell Room 1 and is headed towards Cell Room 2.

>e
You can't go that way.

The security guard is in Cell Room 2 and is headed towards Security Room.

>w
You can't go that way.

The security guard is in Security Room and is headed towards security checkpoint 2.

>n
You can't go that way.

The security guard is in security checkpoint 2 and is headed towards cafeteria.

>s
Cell Room 1
The cells are on the northern side of the room. There's another cell room to the east.

The security guard is in cafeteria and is headed towards security checkpoint 1.

>e
Cell Room 2
The cells are on the northern side of the room. There's another cell room to the west and the security room is to east. The cafeteria is to the south.

You can see a metal door and Joe here.

The security guard is in security checkpoint 1 and is headed towards Storage Room.
You see Joe. He has been in this prison for 50 years, so he probably knows a lot about it. Try talking to him.

>talk
(to Joe)
"Sup Joe," you say.

"What do you want?" he replies.

You can ask him about the prison layout or the security guards or the door.
The security guard is in Storage Room and is headed towards Prison Bathroom.
You see Joe. He has been in this prison for 50 years, so he probably knows a lot about it. Try talking to him.

>answers pls
That's not a verb I recognise.

>lets talk
That's not a verb I recognise.

>talk
(to Joe)
"Sup Joe," you say.

"What do you want?" he replies.

You can ask him about the prison layout or the security guards or the door.
The security guard is in Prison Bathroom and is headed towards Cell Room 1.
You see Joe. He has been in this prison for 50 years, so he probably knows a lot about it. Try talking to him.

>talk to joe
"Sup Joe," you say.

"What do you want?" he replies.

You can ask him about the prison layout or the security guards or the door.
The security guard is in Cell Room 1 and is headed towards Cell Room 2.
You see Joe. He has been in this prison for 50 years, so he probably knows a lot about it. Try talking to him.

>ask
Whom do you want to ask?

>ask joe
What do you want to ask Joe for?

>escape
You can't see any such thing.

>ask joe about prison layout
There are eight rooms and two exits. If you want to leave, you'll have to go through one of the security checkpoints, but be careful because there are guards there.You need some kind of disguise to sneak past them.

The security guard is in Cell Room 2 and is headed towards Security Room.
You see Joe. He has been in this prison for 50 years, so he probably knows a lot about it. Try talking to him.

    *** The security guard sees you and chases you. You trip on a pebble and get caught. You have been moved to a higher security cell. Good luck escaping from there. ***

Would you like to RESTART, RESTORE a saved game, QUIT or UNDO the last command?

>restart
You beg to the guard to let you free. "If you can't do the time, don't do the crime," he replies coldly. You'll go insane if you stay in prison any longer. Find a way to escape without being caught by the guard. Never be in the same room as him or he'll catch you. The only place you're safe from him is in the the cells.

Jail Break
An Interactive Fiction by tendo19
Release 1 / Serial number 190417 / Inform 7 build 6M62 (I6/v6.33 lib 6/12N) SD

your cell
You're in a small cramped space with a thin mattress and a filthy toilet. Hide here if the security guard comes. You notice that your cell is not fully locked. Go south to leave your cell.

>s
Cell Room 1
The cells are on the northern side of the room. There's another cell room to the east.

The security guard is in security checkpoint 2 and is headed towards cafeteria.

* * *

>e
Cell Room 2
The cells are on the northern side of the room. There's another cell room to the west and the security room is to east. The cafeteria is to the south.

You can see a metal door and Joe here.

The security guard is in cafeteria and is headed towards security checkpoint 1.
You see Joe. He has been in this prison for 50 years, so he probably knows a lot about it. Try talking to him.

>talk
(to Joe)
"Sup Joe," you say.

"What do you want?" he replies.

You can ask him about the prison layout or the security guards or the door.
The security guard is in security checkpoint 1 and is headed towards Storage Room.
You see Joe. He has been in this prison for 50 years, so he probably knows a lot about it. Try talking to him.

>ask joe
What do you want to ask Joe for?

>ask joe about prison
There are eight rooms and two exits. If you want to leave, you'll have to go through one of the security checkpoints, but be careful because there are guards there.You need some kind of disguise to sneak past them.

The security guard is in Storage Room and is headed towards Prison Bathroom.
You see Joe. He has been in this prison for 50 years, so he probably knows a lot about it. Try talking to him.

>disguise
That's not a verb I recognise.

>use joe
That's not a verb I recognise.

>wear uniform
You can't see any such thing.

>room 5
That's not a verb I recognise.

>s
(first opening the metal door)
It seems to be locked.

The security guard is in Prison Bathroom and is headed towards Cell Room 1.
You see Joe. He has been in this prison for 50 years, so he probably knows a lot about it. Try talking to him.

>w
Cell Room 1
The cells are on the northern side of the room. There's another cell room to the east.

You can see a security guard here.

The security guard is in Cell Room 1 and is headed towards Cell Room 2.

    *** The security guard sees you and chases you. You trip on a pebble and get caught. You have been moved to a higher security cell. Good luck escaping from there. ***

Would you like to RESTART, RESTORE a saved game, QUIT or UNDO the last command?

>nundo
Please give one of the answers above.

Would you like to RESTART, RESTORE a saved game, QUIT or UNDO the last command?

>n
Please give one of the answers above.

Would you like to RESTART, RESTORE a saved game, QUIT or UNDO the last command?

>undo
Cell Room 2
[Previous turn undone.]

>n
Joe's Cell
Joe's room is a lot stinkier than your's. The smell is probably coming from his toilet. You're safe from the guard when you're in this room.

You can see Urinal (in which is a key card) here.

The security guard is in Cell Room 1 and is headed towards Cell Room 2.

>z
Time passes.

You see the security guard heading to the next room.
The security guard is in Cell Room 2 and is headed towards Security Room.

>take key card
Taken.

The security guard is in Security Room and is headed towards security checkpoint 2.

* * *

>s
Cell Room 2
The cells are on the northern side of the room. There's another cell room to the west and the security room is to east. The cafeteria is to the south.

You can see a metal door and Joe here.

The security guard is in security checkpoint 2 and is headed towards cafeteria.
You see Joe. He has been in this prison for 50 years, so he probably knows a lot about it. Try talking to him.

>s
(first opening the metal door)
It seems to be locked.

The security guard is in cafeteria and is headed towards security checkpoint 1.
You see Joe. He has been in this prison for 50 years, so he probably knows a lot about it. Try talking to him.

>use key card
That's not a verb I recognise.

>e
Security Room
There's cell room to the west and a security checkpoint to the south. Don't go south unless you can sneak past the guard.

You can see Security camera monitor, a bulletin board (in which is a note) and Trash can (in which is Piece of paper) here.

The security guard is in security checkpoint 1 and is headed towards Storage Room.

>s
    *** The guard sees you. You sprint towards the exit, but he grabs you before you can get away.  ***

Would you like to RESTART, RESTORE a saved game, QUIT or UNDO the last command?

* * *

>undo
Security Room
[Previous turn undone.]

>w
Cell Room 2
The cells are on the northern side of the room. There's another cell room to the west and the security room is to east. The cafeteria is to the south.

You can see a metal door and Joe here.

The security guard is in Storage Room and is headed towards Prison Bathroom.
You see Joe. He has been in this prison for 50 years, so he probably knows a lot about it. Try talking to him.

>examine door
This door is headed south. Enter pin code to unlock the metal door.

The security guard is in Prison Bathroom and is headed towards Cell Room 1.
You see Joe. He has been in this prison for 50 years, so he probably knows a lot about it. Try talking to him.

Please enter the pin code.

I beg your pardon?

Please enter the pin code.

I beg your pardon?

Please enter the pin code.

>12
Incorrect pin code, door remains locked.

Would you like to try again? (Yes or No)

>34
Would you like to try again? (Yes or No)

* * *

>s
(first opening the metal door)
It seems to be locked.

The security guard is in Cell Room 1 and is headed towards Cell Room 2.
You see Joe. He has been in this prison for 50 years, so he probably knows a lot about it. Try talking to him.

>n
Joe's Cell
Joe's room is a lot stinkier than your's. The smell is probably coming from his toilet. You're safe from the guard when you're in this room.

You can see Urinal (empty) here.

You see the security guard heading to the next room.
The security guard is in Cell Room 2 and is headed towards Security Room.

* * *

>s
Cell Room 2
The cells are on the northern side of the room. There's another cell room to the west and the security room is to east. The cafeteria is to the south.

You can see a metal door and Joe here.

The security guard is in Security Room and is headed towards security checkpoint 2.
You see Joe. He has been in this prison for 50 years, so he probably knows a lot about it. Try talking to him.

>e
Security Room
There's cell room to the west and a security checkpoint to the south. Don't go south unless you can sneak past the guard.

You can see Security camera monitor, a bulletin board (in which is a note) and Trash can (in which is Piece of paper) here.

The security guard is in security checkpoint 2 and is headed towards cafeteria.

>examine trash can
There's a rubberband, a gum, and a tiny piece of paper.

In Trash can is Piece of paper.

The security guard is in cafeteria and is headed towards security checkpoint 1.

>examine paper
There's a number written on it. It is the number 69.

The security guard is in security checkpoint 1 and is headed towards Storage Room.

>examine bulletin board
It has a single piece of paper pinned on it.

In the bulletin board is a note.

The security guard is in Storage Room and is headed towards Prison Bathroom.

>examine note
It reads: Door Pin Code: 9283 . . . a piece of the paper is missing. There's also an arrow pointing from right to left. What could the last two digits be?

The security guard is in Prison Bathroom and is headed towards Cell Room 1.

>w
Cell Room 2
The cells are on the northern side of the room. There's another cell room to the west and the security room is to east. The cafeteria is to the south.

You can see a metal door and Joe here.

The security guard is in Cell Room 1 and is headed towards Cell Room 2.
You see Joe. He has been in this prison for 50 years, so he probably knows a lot about it. Try talking to him.

* * *

>s
Cell Room 2
The cells are on the northern side of the room. There's another cell room to the west and the security room is to east. The cafeteria is to the south.

You can see a metal door and Joe here.

The security guard is in Security Room and is headed towards security checkpoint 2.
You see Joe. He has been in this prison for 50 years, so he probably knows a lot about it. Try talking to him.

>examine door
This door is headed south. Enter pin code to unlock the metal door.

The security guard is in security checkpoint 2 and is headed towards cafeteria.
You see Joe. He has been in this prison for 50 years, so he probably knows a lot about it. Try talking to him.

Please enter the pin code.

>928369
Incorrect pin code, door remains locked.

Would you like to try again? (Yes or No)

* * *

>yes
Please enter the pin code.

>699283
Incorrect pin code, door remains locked.

Would you like to try again? (Yes or No)

>yes
Please enter the pin code.

>968329
Incorrect pin code, door remains locked.

Would you like to try again? (Yes or No)

>yes
Please enter the pin code.

>963829
**BUZZ**  Access granted

>s
cafeteria
There's a cell room to the north, bathroom to the west, security checkpoint to the east, and another security checkpoint to the south. Don't go east or south unless you can sneak past the guard.

You can see a metal door and a security guard here.

The security guard is in cafeteria and is headed towards security checkpoint 1.

    *** The security guard sees you and chases you. You trip on a pebble and get caught. You have been moved to a higher security cell. Good luck escaping from there. ***

Would you like to RESTART, RESTORE a saved game, QUIT or UNDO the last command?

>undo
Cell Room 2
[Previous turn undone.]

>z
Time passes.

The security guard is in cafeteria and is headed towards security checkpoint 1.
You see Joe. He has been in this prison for 50 years, so he probably knows a lot about it. Try talking to him.

>s
cafeteria
There's a cell room to the north, bathroom to the west, security checkpoint to the east, and another security checkpoint to the south. Don't go east or south unless you can sneak past the guard.

You can see a metal door here.

The security guard is in security checkpoint 1 and is headed towards Storage Room.

>s
    *** The guard sees you. You sprint towards the exit, but he grabs you before you can get away.  ***

Would you like to RESTART, RESTORE a saved game, QUIT or UNDO the last command?

* * *

>undo
cafeteria
[Previous turn undone.]

>n
Cell Room 2
The cells are on the northern side of the room. There's another cell room to the west and the security room is to east. The cafeteria is to the south.

You can see a metal door and Joe here.

The security guard is in Storage Room and is headed towards Prison Bathroom.
You see Joe. He has been in this prison for 50 years, so he probably knows a lot about it. Try talking to him.

>undo
cafeteria
[Previous turn undone.]

>w
Prison Bathroom
The cafeteria is to the east and the storage room is to the south.

You can see storage door here.

The security guard is in Storage Room and is headed towards Prison Bathroom.

* * *

>w
Prison Bathroom
The cafeteria is to the east and the storage room is to the south.

You can see storage door here.

The security guard is in Cell Room 1 and is headed towards Cell Room 2.

>unlck dooooor
That's not a verb I recognise.

>unlock door
(with the key card)
You unlock storage door.

The security guard is in Cell Room 2 and is headed towards Security Room.

>unlock door with key card
That's unlocked at the moment.

The security guard is in Security Room and is headed towards security checkpoint 2.

>s
(first opening storage door)

Storage Room
The bathroom is to the north and there's a security checkpoint to the east. Don't go east unless you can sneak past the guard.

You can see storage door and Security Uniform here.

The security guard is in security checkpoint 2 and is headed towards cafeteria.

>wear uniform
(first taking Security Uniform)
You put on Security Uniform.

The security guard is in cafeteria and is headed towards security checkpoint 1.

>n
Prison Bathroom
The cafeteria is to the east and the storage room is to the south.

You can see storage door here.

The security guard is in security checkpoint 1 and is headed towards Storage Room.

>e
cafeteria
There's a cell room to the north, bathroom to the west, security checkpoint to the east, and another security checkpoint to the south. Don't go east or south unless you can sneak past the guard.

You can see a metal door here.

The security guard is in Storage Room and is headed towards Prison Bathroom.

>s
Act natural, the exit is right in front of you!

The security guard is in Prison Bathroom and is headed towards Cell Room 1.

>n
cafeteria
There's a cell room to the north, bathroom to the west, security checkpoint to the east, and another security checkpoint to the south. Don't go east or south unless you can sneak past the guard.

You can see a metal door here.

The security guard is in Cell Room 1 and is headed towards Cell Room 2.

>s
Act natural, the exit is right in front of you!

The security guard is in Cell Room 2 and is headed towards Security Room.

>w
Storage Room
The bathroom is to the north and there's a security checkpoint to the east. Don't go east unless you can sneak past the guard.

You can see storage door here.

The security guard is in Security Room and is headed towards security checkpoint 2.

>e
Act natural, the exit is right in front of you!

The security guard is in security checkpoint 2 and is headed towards cafeteria.

>nw
You can't go that way.

The security guard is in cafeteria and is headed towards security checkpoint 1.

>e
Freedom
You're free!

The security guard is in security checkpoint 1 and is headed towards Storage Room.

    *** You're free! Now go back home and stay out of trouble. ***

Would you like to RESTART, RESTORE a saved game, QUIT or UNDO the last command?

* * *

>s
Cell Room 1
The cells are on the northern side of the room. There's another cell room to the east.

The security guard is in security checkpoint 1 and is headed towards Storage Room.

>e
Cell Room 2
The cells are on the northern side of the room. There's another cell room to the west and the security room is to east. The cafeteria is to the south.

You can see a metal door and Joe here.

The security guard is in Storage Room and is headed towards Prison Bathroom.
You see Joe. He has been in this prison for 50 years, so he probably knows a lot about it. Try talking to him.

>x door
Enter pin code to unlock the metal door.

The security guard is in Prison Bathroom and is headed towards Cell Room 1.
You see Joe. He has been in this prison for 50 years, so he probably knows a lot about it. Try talking to him.

Please enter the pin code.

I beg your pardon?

Please enter the pin code.

>84394
Incorrect pin code, door remains locked.

Would you like to try again? (Yes or No)

* * *

>talk to joe
"Sup Joe," you say.

"What do you want?" he replies.

You can ask him about the prison layout or the security guardsor the door.
The security guard is in Cell Room 1 and is headed towards Cell Room 2.
You see Joe. He has been in this prison for 50 years, so he probably knows a lot about it. Try talking to him.

>s
(first opening the metal door)
It seems to be locked.

The security guard is in Cell Room 2 and is headed towards Security Room.
You see Joe. He has been in this prison for 50 years, so he probably knows a lot about it. Try talking to him.

    *** The security guard sees you and chases you. You trip on a pebble and get caught. You have been moved to a higher security cell. Good luck escaping from there. ***

Would you like to RESTART, RESTORE a saved game, QUIT or UNDO the last command?

>undo
Cell Room 2
[Previous turn undone.]

>n
Joe's Cell
...

You see the security guard heading to the next room.
The security guard is in Cell Room 2 and is headed towards Security Room.

>s
Cell Room 2
The cells are on the northern side of the room. There's another cell room to the west and the security room is to east. The cafeteria is to the south.

You can see a metal door and Joe here.

The security guard is in Security Room and is headed towards security checkpoint 2.
You see Joe. He has been in this prison for 50 years, so he probably knows a lot about it. Try talking to him.

>talk to joe
"Sup Joe," you say.

"What do you want?" he replies.

You can ask him about the prison layout or the security guardsor the door.
The security guard is in security checkpoint 2 and is headed towards cafeteria.
You see Joe. He has been in this prison for 50 years, so he probably knows a lot about it. Try talking to him.

>ask joe about security door
There is no reply.

The security guard is in cafeteria and is headed towards security checkpoint 1.
You see Joe. He has been in this prison for 50 years, so he probably knows a lot about it. Try talking to him.

>ask about door
You can't see any such thing.

>ask about layout
You can't see any such thing.

>ask him about the door
There is no reply.

The security guard is in security checkpoint 1 and is headed towards Storage Room.
You see Joe. He has been in this prison for 50 years, so he probably knows a lot about it. Try talking to him.

>ask him about door
If you  examine the door closely, you'll see that you need a pincode to unlock the door. The security room is east from here, so maybe you be able to find some clues there.

The security guard is in Storage Room and is headed towards Prison Bathroom.
You see Joe. He has been in this prison for 50 years, so he probably knows a lot about it. Try talking to him.

>e
Security Room
There's cell room to the west and a security checkpoint to the south.

You can see Security camera monitor, a bulletin board (in which is a note) and Trash can (in which is Piece of paper) here.

The security guard is in Prison Bathroom and is headed towards Cell Room 1.

>x note
It reads: Door Pin Code: 9283 . . . a piece of the paper is missing. There's also an arrow pointing from right to left. What could the last two digits be?

The security guard is in Cell Room 1 and is headed towards Cell Room 2.

>take paper
Taken.

The security guard is in Cell Room 2 and is headed towards Security Room.

>s
    *** The guard sees you. You sprint towards the exit, but he grabs you before you can get away.  ***

Would you like to RESTART, RESTORE a saved game, QUIT or UNDO the last command?

* * *

>undo
Security Room
[Previous turn undone.]

>n
You can't go that way.

The security guard is in Security Room and is headed towards security checkpoint 2.

    *** The security guard sees you and chases you. You trip on a pebble and get caught. You have been moved to a higher security cell. Good luck escaping from there. ***

Would you like to RESTART, RESTORE a saved game, QUIT or UNDO the last command?

>undo
Security Room
[Previous turn undone.]

>undo
Cell Room 2
[Previous turn undone.]

>n
Joe's Cell
...

The security guard is in Prison Bathroom and is headed towards Cell Room 1.

>s
Cell Room 2
The cells are on the northern side of the room. There's another cell room to the west and the security room is to east. The cafeteria is to the south.

You can see a metal door and Joe here.

The security guard is in Cell Room 1 and is headed towards Cell Room 2.
You see Joe. He has been in this prison for 50 years, so he probably knows a lot about it. Try talking to him.

>e
Security Room
There's cell room to the west and a security checkpoint to the south.

You can see Security camera monitor, a bulletin board (in which is a note) and Trash can (in which is Piece of paper) here.

The security guard is in Cell Room 2 and is headed towards Security Room.

>w
Cell Room 2
The cells are on the northern side of the room. There's another cell room to the west and the security room is to east. The cafeteria is to the south.

You can see a metal door and Joe here.

The security guard is in Security Room and is headed towards security checkpoint 2.
You see Joe. He has been in this prison for 50 years, so he probably knows a lot about it. Try talking to him.

>e
Security Room
There's cell room to the west and a security checkpoint to the south.

You can see Security camera monitor, a bulletin board (in which is a note) and Trash can (in which is Piece of paper) here.

The security guard is in security checkpoint 2 and is headed towards cafeteria.

>x note
It reads: Door Pin Code: 9283 . . . a piece of the paper is missing. There's also an arrow pointing from right to left. What could the last two digits be?

The security guard is in cafeteria and is headed towards security checkpoint 1.

>x paper
There's a number written on it. It is the number 69.

The security guard is in security checkpoint 1 and is headed towards Storage Room.

>w
Cell Room 2
The cells are on the northern side of the room. There's another cell room to the west and the security room is to east. The cafeteria is to the south.

You can see a metal door and Joe here.

The security guard is in Storage Room and is headed towards Prison Bathroom.
You see Joe. He has been in this prison for 50 years, so he probably knows a lot about it. Try talking to him.

>x metal door
Enter pin code to unlock the metal door.

The security guard is in Prison Bathroom and is headed towards Cell Room 1.
You see Joe. He has been in this prison for 50 years, so he probably knows a lot about it. Try talking to him.

Please enter the pin code.

>928369
Incorrect pin code, door remains locked.

Would you like to try again? (Yes or No)

* * *

>n
Joe's Cell
...

The security guard is in Cell Room 1 and is headed towards Cell Room 2.

* * *

>s
Cell Room 2
The cells are on the northern side of the room. There's another cell room to the west and the security room is to east. The cafeteria is to the south.

You can see a metal door and Joe here.

The security guard is in Security Room and is headed towards security checkpoint 2.
You see Joe. He has been in this prison for 50 years, so he probably knows a lot about it. Try talking to him.

>e
Security Room
There's cell room to the west and a security checkpoint to the south.

You can see Security camera monitor, a bulletin board (in which is a note) and Trash can (in which is Piece of paper) here.

The security guard is in security checkpoint 2 and is headed towards cafeteria.

* * *

>w
Cell Room 2
The cells are on the northern side of the room. There's another cell room to the west and the security room is to east. The cafeteria is to the south.

You can see a metal door and Joe here.

The security guard is in Storage Room and is headed towards Prison Bathroom.
You see Joe. He has been in this prison for 50 years, so he probably knows a lot about it. Try talking to him.

>x door
Enter pin code to unlock the metal door.

The security guard is in Prison Bathroom and is headed towards Cell Room 1.
You see Joe. He has been in this prison for 50 years, so he probably knows a lot about it. Try talking to him.

Please enter the pin code.

>963829
**BUZZ**  Access granted

>s
cafeteria
There's a cell room to the north, bathroom to the west, security checkpoint to the east, and another security checkpoint to the south.

You can see a metal door and Ceramic plate here.

The security guard is in Cell Room 1 and is headed towards Cell Room 2.

>x plate
The plate is smothered with spaghetti sauce and other remnants from last night's dinner.

The security guard is in Cell Room 2 and is headed towards Security Room.

>w
Prison Bathroom
There's a metal door to the north, the cafeteria is to the east, and the storage room is to the south.

You can see storage door and Broken plunger here.

The security guard is in Security Room and is headed towards security checkpoint 2.

>x plunger
The head of the plunger seems to be missing.

The security guard is in security checkpoint 2 and is headed towards cafeteria.

>take all
Broken plunger: Taken.

The security guard is in cafeteria and is headed towards security checkpoint 1.

>e
cafeteria
There's a cell room to the north, bathroom to the west, security checkpoint to the east, and another security checkpoint to the south.

You can see a metal door and Ceramic plate here.

The security guard is in security checkpoint 1 and is headed towards Storage Room.

>e
    *** The guard sees you. You sprint towards the exit, but he grabs you before you can get away.  ***

Would you like to RESTART, RESTORE a saved game, QUIT or UNDO the last command?

* * *

>undo
cafeteria
[Previous turn undone.]

>w
Prison Bathroom
There's a metal door to the north, the cafeteria is to the east, and the storage room is to the south.

You can see storage door here.

The security guard is in Storage Room and is headed towards Prison Bathroom.

>s
(first opening storage door)
It seems to be locked.

The security guard is in Prison Bathroom and is headed towards Cell Room 1.

    *** The security guard sees you and chases you. You trip on a pebble and get caught. You have been moved to a higher security cell. Good luck escaping from there. ***

Would you like to RESTART, RESTORE a saved game, QUIT or UNDO the last command?

>undo
Prison Bathroom
[Previous turn undone.]

>e
cafeteria
There's a cell room to the north, bathroom to the west, security checkpoint to the east, and another security checkpoint to the south.

You can see a metal door and Ceramic plate here.

The security guard is in Prison Bathroom and is headed towards Cell Room 1.

>n
Cell Room 2
The cells are on the northern side of the room. There's another cell room to the west and the security room is to east. The cafeteria is to the south.

You can see a metal door and Joe here.

The security guard is in Cell Room 1 and is headed towards Cell Room 2.
You see Joe. He has been in this prison for 50 years, so he probably knows a lot about it. Try talking to him.

>n
Joe's Cell
...

You see the security guard heading to the next room.
The security guard is in Cell Room 2 and is headed towards Security Room.

* * *

>talk to joe
"Sup Joe," you say.

"What do you want?" he replies.

You can ask him about the prison layout or the security guardsor the door.
The security guard is in security checkpoint 2 and is headed towards cafeteria.
You see Joe. He has been in this prison for 50 years, so he probably knows a lot about it. Try talking to him.

>ask him about security guards
There are three security guards in this prison. The first one walks around the prison. You should avoid being in the same room as him. He always takes same route, so you should be able to figure where he's headed.

One of them is guarding security checkpoint 1 and the last one is guarding security checkpoint 2. You need to find a way to sneak past all three of them if you want to escape. Whatever you do, don't make any noise.

The only place you're truly safe is in the cells. If the guard comes, just go into one of the cells and don't act suspicious.

The security guard is in cafeteria and is headed towards security checkpoint 1.
You see Joe. He has been in this prison for 50 years, so he probably knows a lot about it. Try talking to him.

>ask him about prison layout
There are eight rooms and two exits. If you want to leave, you'll have to go through one of the security checkpoints, but be careful because there are guards there.You need some kind of disguise to sneak past them.

The security guard is in security checkpoint 1 and is headed towards Storage Room.
You see Joe. He has been in this prison for 50 years, so he probably knows a lot about it. Try talking to him.

>e
Security Room
There's cell room to the west and a security checkpoint to the south.

You can see Security camera monitor, a bulletin board (in which is a note) and Trash can (in which is Piece of paper) here.

The security guard is in Storage Room and is headed towards Prison Bathroom.

>x monitor
You can see one guard in security checkpoint 1 and another guard at security checkpoint 2. Those are the only ways to escape. You have to figure out a way to get past them without being noticed.

The security guard is in Prison Bathroom and is headed towards Cell Room 1.

>w
Cell Room 2
The cells are on the northern side of the room. There's another cell room to the west and the security room is to east. The cafeteria is to the south.

You can see a metal door and Joe here.

The security guard is in Cell Room 1 and is headed towards Cell Room 2.
You see Joe. He has been in this prison for 50 years, so he probably knows a lot about it. Try talking to him.

>n
Joe's Cell
...

You see the security guard heading to the next room.
The security guard is in Cell Room 2 and is headed towards Security Room.

* * *

>s
Cell Room 2
The cells are on the northern side of the room. There's another cell room to the west and the security room is to east. The cafeteria is to the south.

You can see a metal door and Joe here.

The security guard is in Security Room and is headed towards security checkpoint 2.
You see Joe. He has been in this prison for 50 years, so he probably knows a lot about it. Try talking to him.

>s
cafeteria
There's a cell room to the north, bathroom to the west, security checkpoint to the east, and another security checkpoint to the south.

You can see a metal door and Ceramic plate here.

The security guard is in security checkpoint 2 and is headed towards cafeteria.

>take all
Ceramic plate: Taken.

The security guard is in cafeteria and is headed towards security checkpoint 1.

    *** The security guard sees you and chases you. You trip on a pebble and get caught. You have been moved to a higher security cell. Good luck escaping from there. ***

Would you like to RESTART, RESTORE a saved game, QUIT or UNDO the last command?

>undo
cafeteria
[Previous turn undone.]

>n
Cell Room 2
The cells are on the northern side of the room. There's another cell room to the west and the security room is to east. The cafeteria is to the south.

You can see a metal door and Joe here.

The security guard is in cafeteria and is headed towards security checkpoint 1.
You see Joe. He has been in this prison for 50 years, so he probably knows a lot about it. Try talking to him.

>s
cafeteria
There's a cell room to the north, bathroom to the west, security checkpoint to the east, and another security checkpoint to the south.

You can see a metal door and Ceramic plate here.

The security guard is in security checkpoint 1 and is headed towards Storage Room.

>take all
Ceramic plate: Taken.

The security guard is in Storage Room and is headed towards Prison Bathroom.

>z
Time passes.

The security guard is in Prison Bathroom and is headed towards Cell Room 1.

>w
Prison Bathroom
There's a metal door to the north, the cafeteria is to the east, and the storage room is to the south.

You can see storage door here.

The security guard is in Cell Room 1 and is headed towards Cell Room 2.

>x plate
The plate is smothered with spaghetti sauce and other remnants from last night's dinner.

The security guard is in Cell Room 2 and is headed towards Security Room.

>break plate
Violence isn't the answer to this one.

The security guard is in Security Room and is headed towards security checkpoint 2.

>drop plate
Dropped.

The security guard is in security checkpoint 2 and is headed towards cafeteria.

>take all
Ceramic plate: Taken.

The security guard is in cafeteria and is headed towards security checkpoint 1.

>throw plate
Dropped.

The security guard is in security checkpoint 1 and is headed towards Storage Room.

>take plate
Taken.

The security guard is in Storage Room and is headed towards Prison Bathroom.

>purloin key card
[Purloined.]

* * *

I beg your pardon?

>w
Prison Bathroom
There's a metal door to the north, the cafeteria is to the east, and the storage room is to the south.

You can see storage door here.

The security guard is in Cell Room 1 and is headed towards Cell Room 2.

>s
(first opening storage door)
It seems to be locked.

The security guard is in Cell Room 2 and is headed towards Security Room.

>unlock storage door
What do you want to unlock storage door with?

>key
You unlock storage door.

The security guard is in Security Room and is headed towards security checkpoint 2.

>s
(first opening storage door)

Storage Room
The bathroom is to the north and there's a security checkpoint to the east.

You can see storage door and Security Uniform here.

The security guard is in security checkpoint 2 and is headed towards cafeteria.

>put on uniform
(first taking Security Uniform)
You put on Security Uniform.

The security guard is in cafeteria and is headed towards security checkpoint 1.

>e
Act natural, the exit is right in front of you!

The security guard is in security checkpoint 1 and is headed towards Storage Room.

>n
cafeteria
There's a cell room to the north, bathroom to the west, security checkpoint to the east, and another security checkpoint to the south.

You can see a metal door here.

The security guard is in Storage Room and is headed towards Prison Bathroom.

>s
Act natural, the exit is right in front of you!

The security guard is in Prison Bathroom and is headed towards Cell Room 1.

>s
You can't go that way.

The security guard is in Cell Room 1 and is headed towards Cell Room 2.

>e
Freedom
You're free! Now you don't have to sleep next to your stinky cellmate.

The security guard is in Cell Room 2 and is headed towards Security Room.

    *** You win! ***

Would you like to RESTART, RESTORE a saved game, QUIT or UNDO the last command?

* * *

>s
Cell Room 1
The cells are on the northern side of the room. There's another cell room to the east.

The security guard is in security checkpoint 1 and is headed towards Storage Room.

>s
South Security Room
The bathroom is to the north and there's a security checkpoint to the east.

>e
security checkpoint 1
There's a security room to the west and the cafeteria to the north.

>e
You can't go that way.

* * *

>s
Cell Room 1
Your cell is on the northern side of the room. There's another cell room to the east.

The security guard is in security checkpoint 2 and is headed towards cafeteria.

>restart
Are you sure you want to restart?

>yes
You beg to the guard to let you free. "If you can't do the time, don't do the crime," he replies coldly. You'll go insane if you stay in prison any longer. Find a way to escape without being caught by any of the guards by never being in the same room as them.

Jail Break
An Interactive Fiction by tendo19
Release 1 / Serial number 190314 / Inform 7 build 6M62 (I6/v6.33 lib 6/12N) SD

Cell Room 1
There's another cell room to the east and the bathroom is to the south.

>s
Prison Bathroom
There's a cell room to the north and the cafeteria is to the east.

>s
South Security Room
The bathroom is to the north and there's a security checkpoint to the east.

* * *

>e
security checkpoint 1
There's a security room to the west and the cafeteria to the north.

>n
Cafeteria
There's a cell room to the north, bathroom to the west, security checkpoint to the east, and another security checkpoint to the south.

>w
Prison Bathroom
There's a cell room to the north and the cafeteria is to the east.

>e
Cafeteria
There's a cell room to the north, bathroom to the west, security checkpoint to the east, and another security checkpoint to the south.

* * *

>e
security checkpoint 2
There's a security room to the north and the cafeteria to the west.

>n
East Security Room
There's cell room to the west and a security checkpoint to the south.

You can see Security Guard here.

* * *

>s
Cell Room 1
Your cell is on the northern side of the room. There's another cell room to the east.

The security guard is in security checkpoint 2 and is headed towards cafeteria.

>s
You can't go that way.

The security guard is in cafeteria and is headed towards security checkpoint 1.

I beg your pardon?

>w
You can't go that way.

>e
security checkpoint 1
There's a security room to the west and the cafeteria to the north.

I beg your pardon?

>s
You can't go that way.

>c
That's not a verb I recognise.

I beg your pardon?

>x
What do you want to examine?

* * *

>s
You can't go that way.

>n
Prison Bathroom
There's a cell room to the north and the cafeteria is to the east.

* * *

>n
Cell Room 1
There's another cell room to the east and the bathroom is to the south.

>e
Cell Room 2
There's another cell room to the west and the security room is to east. The cafeteria is to the south.

You can see Joe here.

>e
East Security Room
There's cell room to the west and a security checkpoint to the south.

You can see Security Guard here.

Sam heads to security checkpoint 2.

>s
security checkpoint 2
There's a security room to the north and the cafeteria to the west.

You can see Security Guard here.

Sam heads to East Security Room.

>w
Cafeteria
There's a cell room to the north, bathroom to the west, security checkpoint to the east, and another security checkpoint to the south.

>w
Prison Bathroom
There's a cell room to the north and the cafeteria is to the east.

>s
South Security Room
The bathroom is to the north and there's a security checkpoint to the east.

* * *

>e
security checkpoint 1
There's a security room to the west and the cafeteria to the north.

>e
Freedom
You're free! Now you don't have to sleep next to your stinky cellmate.

    *** Yay! ***

Would you like to RESTART, RESTORE a saved game, QUIT or UNDO the last command?

>w
Please give one of the answers above.

Would you like to RESTART, RESTORE a saved game, QUIT or UNDO the last command?

Please give one of the answers above.

Would you like to RESTART, RESTORE a saved game, QUIT or UNDO the last command?

>e
Please give one of the answers above.

Would you like to RESTART, RESTORE a saved game, QUIT or UNDO the last command?

* * *

>s
You can't go that way.

The security guard is in cafeteria and is headed towards security checkpoint 1.

>e
Cell Room 2
The cells are on the northern side of the room. There's another cell room to the west and the security room is to east. The cafeteria is to the south.

You can see a metal door and Joe here.

The security guard is in security checkpoint 1 and is headed towards Storage Room. You see Joe. He has been in this prison for 50 years, so he probably knows a lot about it. Try talking to him.

>e
Freedom
You're free! Now you don't have to sleep next to your stinky cellmate.

    *** Yay! ***

Would you like to RESTART, RESTORE a saved game, QUIT or UNDO the last command?

>restart
You beg to the guard to let you free. "If you can't do the time, don't do the crime," he replies coldly. You'll go insane if you stay in prison any longer. Find a way to escape without being caught by any of the guards by never being in the same room as them.

Jail Break
An Interactive Fiction by tendo19
Release 1 / Serial number 190314 / Inform 7 build 6M62 (I6/v6.33 lib 6/12N) SD

Cell Room 1
There's another cell room to the east and the bathroom is to the south.

>s
Prison Bathroom
There's a cell room to the north and the cafeteria is to the east.

>e
Cafeteria
There's a cell room to the north, bathroom to the west, security checkpoint to the east, and another security checkpoint to the south.

Security guard arrives from Cafeteria.

>e
security checkpoint 2
There's a security room to the north and the cafeteria to the west.

>s
Freedom
You're free! Now you don't have to sleep next to your stinky cellmate.

    *** Yay! ***

Would you like to RESTART, RESTORE a saved game, QUIT or UNDO the last command?

* * *

>e
Cell Room 2
The cells are on the northern side of the room. There's another cell room to the west and the security room is to east. The cafeteria is to the south.

You can see a metal door and Joe here.

The security guard is in security checkpoint 1 and is headed towards Storage Room. You see Joe. He has been in this prison for 50 years, so he probably knows a lot about it. Try talking to him.

>n
Cafeteria
There's a cell room to the north, bathroom to the west, security checkpoint to the east, and another security checkpoint to the south.

>e
security checkpoint 2
There's a security room to the north and the cafeteria to the west.

>n
East Security Room
There's cell room to the west and a security checkpoint to the south.

>w
Cell Room 2
There's another cell room to the west and the security room is to east. The cafeteria is to the south.

You can see Joe here.

Security guard arrives from Cell Room 2.

>w
Cell Room 1
There's another cell room to the east and the bathroom is to the south.

>e
Cell Room 2
There's another cell room to the west and the security room is to east. The cafeteria is to the south.

You can see Joe here.

>s
Cafeteria
There's a cell room to the north, bathroom to the west, security checkpoint to the east, and another security checkpoint to the south.

>e
security checkpoint 2
There's a security room to the north and the cafeteria to the west.

* * *

>e
Cell Room 2
The cells are on the northern side of the room. There's another cell room to the west and the security room is to east. The cafeteria is to the south.

You can see a metal door and Joe here.

The security guard is in security checkpoint 1 and is headed towards Storage Room. You see Joe. He has been in this prison for 50 years, so he probably knows a lot about it. Try talking to him.

>w
Cell Room 1
There's another cell room to the east and the bathroom is to the south.

You can see a metal door here.

Security guard heads to Storage Room.

>e
Cell Room 2
There's another cell room to the west and the security room is to east. The cafeteria is to the south.

You can see a rusted metal door and Joe here.

Security guard heads to prison bathroom.

>w
Cell Room 1
There's another cell room to the east and the bathroom is to the south.

You can see a metal door here.

Security guard heads to Cell Room 1.

    *** The security guard sees you and chases. You trip on a pebble and get caught. You have been moved to a higher security cell. Good luck escaping from there. ***

Would you like to RESTART, RESTORE a saved game, QUIT or UNDO the last command?

* * *

>e
Cell Room 2
The cells are on the northern side of the room. There's another cell room to the west and the security room is to east. The cafeteria is to the south.

You can see a metal door and Joe here.

The security guard is in security checkpoint 1 and is headed towards Storage Room. You see Joe. He has been in this prison for 50 years, so he probably knows a lot about it. Try talking to him.

>x
(the security guard)
...

Security guard heads to South Security Room.

>n
Cafeteria
There's a cell room to the north, bathroom to the west, security checkpoint to the east, and another security checkpoint to the south.

Security guard heads to Prison Bathroom.

>n
Cell Room 2
There's another cell room to the west and the security room is to east. The cafeteria is to the south.

You can see Joe here.

Security guard heads to Cell Room 1.

>e
East Security Room
There's cell room to the west and a security checkpoint to the south.

Security guard heads to Cell Room 2.

>w
Cell Room 2
There's another cell room to the west and the security room is to east. The cafeteria is to the south.

You can see a security guard and Joe here.

Security guard heads to East Security Room.

>s
Cafeteria
There's a cell room to the north, bathroom to the west, security checkpoint to the east, and another security checkpoint to the south.

Security guard heads to security checkpoint 2.

>x
What do you want to examine?

>room
You can't see any such thing.

>x
What do you want to examine?

>e
You see nothing unexpected in that direction.

Security guard heads to Cafeteria.

>s
security checkpoint 1
There's a security room to the west and the cafeteria to the north.

Security guard heads to security checkpoint 1.

>x
(the security guard)
...

Security guard heads to South Security Room.

* * *

>e
Cell Room 2
The cells are on the northern side of the room. There's another cell room to the west and the security room is to east. The cafeteria is to the south.

You can see a metal door and Joe here.

The security guard is in security checkpoint 1 and is headed towards Storage Room. You see Joe. He has been in this prison for 50 years, so he probably knows a lot about it. Try talking to him.

>z
Time passes.

The security guard is in Storage Room and is headed towards Prison Bathroom. You see Joe. He has been in this prison for 50 years, so he probably knows a lot about it. Try talking to him.

>e
Security Room
There's cell room to the west and a security checkpoint to the south. Don't go south unless you can sneak past the guard.

You can see Security camera monitor, a bulletin board (in which is a note) and Trash can (in which is Piece of paper) here.

The security guard is in Prison Bathroom and is headed towards Cell Room 1.

>w
Cell Room 2
The cells are on the northern side of the room. There's another cell room to the west and the security room is to east. The cafeteria is to the south.

You can see a metal door and Joe here.

The security guard is in Cell Room 1 and is headed towards Cell Room 2.

>n
Joe's Cell
Joe's room is a lot stinkier than your's. The smell is probably coming from his toilet. You're safe from the guard when you're in this room.

You see the security guard heading to the next room.
The security guard is in Cell Room 2 and is headed towards Security Room.

>s
Cell Room 2
The cells are on the northern side of the room. There's another cell room to the west and the security room is to east. The cafeteria is to the south.

You can see a metal door and Joe here.

The security guard is in Security Room and is headed towards security checkpoint 2.

>z
Time passes.

The security guard is in security checkpoint 2 and is headed towards cafeteria.

* * *

>z
Time passes.

The security guard is in Cell Room 1 and is headed towards Cell Room 2.

>n
Joe's Cell
Joe's room is a lot stinkier than your's. The smell is probably coming from his toilet. You're safe from the guard when you're in this room.

You see the security guard heading to the next room.
The security guard is in Cell Room 2 and is headed towards Security Room.

* * *

>s
Cell Room 2
The cells are on the northern side of the room. There's another cell room to the west and the security room is to east. The cafeteria is to the south.

You can see a metal door and Joe here.

The security guard is in Security Room and is headed towards security checkpoint 2.

>talk to joe
"Sup Joe," you say.

"What do you want?" he replies.

You can ask him about the prison layout or the security guards or the door.
The security guard is in security checkpoint 2 and is headed towards cafeteria.

>z
Time passes.

The security guard is in cafeteria and is headed towards security checkpoint 1.

* * *

>n
Joe's Cell
Joe's room is a lot stinkier than your's. The smell is probably coming from his toilet. You're safe from the guard when you're in this room.

You see the security guard heading to the next room.
The security guard is in Cell Room 2 and is headed towards Security Room.

>z
Time passes.

The security guard is in Security Room and is headed towards security checkpoint 2.

>z
Time passes.

The security guard is in security checkpoint 2 and is headed towards cafeteria.

* * *

>z
Time passes.

The security guard is in cafeteria and is headed towards security checkpoint 1.

>talk to joe
You can't see any such thing.

>s
Cell Room 2
The cells are on the northern side of the room. There's another cell room to the west and the security room is to east. The cafeteria is to the south.

You can see a metal door and Joe here.

The security guard is in security checkpoint 1 and is headed towards Storage Room.

>talk to joe
"Sup Joe," you say.

"What do you want?" he replies.

You can ask him about the prison layout or the security guards or the door.
The security guard is in Storage Room and is headed towards Prison Bathroom.

* * *

>s
You can't go that way.

The security guard is in cafeteria and is headed towards security checkpoint 1.

>x door
Enter the six-digit pin code to unlock it.

The security guard is in security checkpoint 1 and is headed towards Storage Room.

Please enter the six-digit pin code.

>928369
**BUZZ**  Access granted

>open door
You open the metal door.

The security guard is in Storage Room and is headed towards prison bathroom.

>s
prison bathroom
There's a metal door to the north, the cafeteria is to the east, and the storage room is to the south.

You can see a metal door and a security guard here.

The security guard is in prison bathroom and is headed towards Cell Room 1.

    *** The security guard sees you and chases you. You trip on a pebble and get caught. You have been moved to a higher security cell. Good luck escaping from there. ***

Would you like to RESTART, RESTORE a saved game, QUIT or UNDO the last command?

>restart
You beg to the guard to let you free. "If you can't do the time, don't do the crime," he replies coldly. You'll go insane if you stay in prison any longer. Find a way to escape without being caught by the guard by never being in the same room as him. The only place you're safe from is in the cell.

Jail Break
An Interactive Fiction by tendo19
Release 1 / Serial number 190409 / Inform 7 build 6M62 (I6/v6.33 lib 6/12N) SD

your cell
You're in a small cramped space with a think mattress and a filthy toilet. You notice that your cell is not fully locked. Go south to leave your cell.

>s
Cell Room 1
The cells are on the northern side of the room.There's another cell room to the east and the bathroom is to the south.

You can see a metal door here.

The security guard is in security checkpoint 2 and is headed towards cafeteria.

>e
Cell Room 2
The cells are on the northern side of the room. There's another cell room to the west and the security room is to east. The cafeteria is to the south.

You can see a rusted metal door and Joe here.

The security guard is in cafeteria and is headed towards security checkpoint 1.

>x door
Please enter the six-digit pin code to unlock it.

The security guard is in security checkpoint 1 and is headed towards Storage Room.

Please enter the six-digit pin code.

>928369
**BUZZ**  Access granted

* * *

>open door
It seems to be locked.

The security guard is in Storage Room and is headed towards prison bathroom.

>restart
Are you sure you want to restart?

>yes
You beg to the guard to let you free. "If you can't do the time, don't do the crime," he replies coldly. You'll go insane if you stay in prison any longer. Find a way to escape without being caught by the guard by never being in the same room as him. The only place you're safe from is in the cell.

Jail Break
An Interactive Fiction by tendo19
Release 1 / Serial number 190409 / Inform 7 build 6M62 (I6/v6.33 lib 6/12N) SD

your cell
You're in a small cramped space with a think mattress and a filthy toilet. You notice that your cell is not fully locked. Go south to leave your cell.

>s
Cell Room 1
The cells are on the northern side of the room.There's another cell room to the east and the bathroom is to the south.

You can see a metal door here.

The security guard is in security checkpoint 2 and is headed towards cafeteria.

>x door
Enter the six-digit pin code to unlock it.

The security guard is in cafeteria and is headed towards security checkpoint 1.

Please enter the six-digit pin code.

* * *

>s
Cell Room 1
Your cell is on the northern side of the room. There's another cell room to the east.

The security guard is in security checkpoint 2 and is headed towards cafeteria.

>x door
Enter the six-digit pin code to unlock it.

The security guard is in cafeteria and is headed towards security checkpoint 1.

Please enter the six-digit pin code.

>112098
**BUZZ**  Access granted

>open door
You open the metal door.

The security guard is in security checkpoint 1 and is headed towards Storage Room.

>s
prison bathroom
There's a metal door to the north, the cafeteria is to the east, and the storage room is to the south.

You can see a metal door here.

The security guard is in Storage Room and is headed towards prison bathroom.

    *** The security guard sees you and chases you. You trip on a pebble and get caught. You have been moved to a higher security cell. Good luck escaping from there. ***

Would you like to RESTART, RESTORE a saved game, QUIT or UNDO the last command?

* * *

>x door
Enter the six-digit pin code to unlock it.

The security guard is in cafeteria and is headed towards security checkpoint 1.

Please enter the six-digit pin code.

>928369
**BUZZ**  Access granted

>s
(first opening the metal door)
It seems to be locked.

The security guard is in security checkpoint 1 and is headed towards Storage Room.

>open door
It seems to be locked.

The security guard is in Storage Room and is headed towards Prison Bathroom.

>e
Cell Room 2
The cells are on the northern side of the room. There's another cell room to the west and the security room is to east. The cafeteria is to the south.

You can see a rusted metal door and Joe here.

The security guard is in Prison Bathroom and is headed towards Cell Room 1.

>n
Joe's Cell
...

The security guard is in Cell Room 1 and is headed towards Cell Room 2.

* * *

>s
Cell Room 2
The cells are on the northern side of the room. There's another cell room to the west and the security room is to east. The cafeteria is to the south.

You can see a rusted metal door and Joe here.

The security guard is in Security Room and is headed towards security checkpoint 2.

>x door
Enter a six-digit pin code to unlock the rusted metal door.

The security guard is in security checkpoint 2 and is headed towards cafeteria.

Please enter the six-digit pin code.

* * *

>928369
**BUZZ**  Access granted

>open door
That's already open.

The security guard is in cafeteria and is headed towards security checkpoint 1.

>s
cafeteria
There's a cell room to the north, bathroom to the west, security checkpoint to the east, and another security checkpoint to the south.

You can see a rusted metal door and Fork here.

The security guard is in security checkpoint 1 and is headed towards Storage Room.

>take fork
Taken.

The security guard is in Storage Room and is headed towards Prison Bathroom.

>s
security checkpoint 1
There's a storage room to the west and the cafeteria to the north.

The security guard is in Prison Bathroom and is headed towards Cell Room 1.

>n
cafeteria
There's a cell room to the north, bathroom to the west, security checkpoint to the east, and another security checkpoint to the south.

You can see a rusted metal door here.

The security guard is in Cell Room 1 and is headed towards Cell Room 2.

>e
security checkpoint 2
There's a security room to the north and the cafeteria to the west.

The security guard is in Cell Room 2 and is headed towards Security Room.

>w
cafeteria
There's a cell room to the north, bathroom to the west, security checkpoint to the east, and another security checkpoint to the south.

You can see a rusted metal door here.

The security guard is in Security Room and is headed towards security checkpoint 2.

>w
Prison Bathroom
There's a metal door to the north, the cafeteria is to the east, and the storage room is to the south.

You can see storage door, a metal door and Broken plunger here.

The security guard is in security checkpoint 2 and is headed towards cafeteria.

>take plunger
Taken.

The security guard is in cafeteria and is headed towards security checkpoint 1.

>n
(first opening the metal door)
It seems to be locked.

The security guard is in security checkpoint 1 and is headed towards Storage Room.

>x door
Which do you mean, storage door or the metal door?

>x metal door
Enter the six-digit pin code to unlock it.

The security guard is in Storage Room and is headed towards Prison Bathroom.

Please enter the six-digit pin code.

>928369
**BUZZ**  Access granted

>n
(first opening the metal door)
It seems to be locked.

The security guard is in Prison Bathroom and is headed towards Cell Room 1.

    *** The security guard sees you and chases you. You trip on a pebble and get caught. You have been moved to a higher security cell. Good luck escaping from there. ***

Would you like to RESTART, RESTORE a saved game, QUIT or UNDO the last command?

>restart
You beg to the guard to let you free. "If you can't do the time, don't do the crime," he replies coldly. You'll go insane if you stay in prison any longer. Find a way to escape without being caught by the guard. Never be in the same room as him or he'll catch you. The only place you're safe from is in the cell.

Jail Break
An Interactive Fiction by tendo19
Release 1 / Serial number 190409 / Inform 7 build 6M62 (I6/v6.33 lib 6/12N) SD

your cell
You're in a small cramped space with a thin mattress and a filthy toilet. You notice that your cell is not fully locked. Go south to leave your cell.

>s
Cell Room 1
The cells are on the northern side of the room.There's another cell room to the east and the bathroom is to the south.

You can see a metal door here.

The security guard is in security checkpoint 2 and is headed towards cafeteria.

* * *

>e
Cell Room 2
The cells are on the northern side of the room. There's another cell room to the west and the security room is to east. The cafeteria is to the south.

You can see a rusted metal door and Joe here.

The security guard is in cafeteria and is headed towards security checkpoint 1.

>x door
Enter a six-digit pin code to unlock the rusted metal door.

The security guard is in security checkpoint 1 and is headed towards Storage Room.

Please enter the six-digit pin code.

>928369
**BUZZ**  Access granted

>s
cafeteria
There's a cell room to the north, bathroom to the west, security checkpoint to the east, and another security checkpoint to the south.

You can see a rusted metal door and Fork here.

The security guard is in Storage Room and is headed towards Prison Bathroom.

>restart
Are you sure you want to restart?

* * *

>s
Cell Room 1
The cells are on the northern side of the room.There's another cell room to the east and the bathroom is to the south.

You can see a metal door here.

The security guard is in security checkpoint 2 and is headed towards cafeteria.

* * *

>x door
Enter the six-digit pin code to unlock it.

The security guard is in cafeteria and is headed towards security checkpoint 1.

Please enter the six-digit pin code.

>963829
**BUZZ**  Access granted

>s
(first opening the metal door)
It seems to be locked.

The security guard is in security checkpoint 1 and is headed towards Storage Room.

>e
Cell Room 2
The cells are on the northern side of the room. There's another cell room to the west and the security room is to east. The cafeteria is to the south.

You can see a rusted metal door and Joe here.

The security guard is in Storage Room and is headed towards Prison Bathroom.

>n
Joe's Cell
...

The security guard is in Prison Bathroom and is headed towards Cell Room 1.

>z
Time passes.

The security guard is in Cell Room 1 and is headed towards Cell Room 2.

I beg your pardon?

>z
Time passes.

You see the security guard heading to the next room.
The security guard is in Cell Room 2 and is headed towards Security Room.

* * *

>x door
Enter a six-digit pin code to unlock the rusted metal door.

The security guard is in security checkpoint 2 and is headed towards cafeteria.

Please enter the six-digit pin code.

>963829
**BUZZ**  Access granted

>s
cafeteria
There's a cell room to the north, bathroom to the west, security checkpoint to the east, and another security checkpoint to the south.

You can see a rusted metal door, a security guard and Ceramic plate here.

The security guard is in cafeteria and is headed towards security checkpoint 1.

    *** The security guard sees you and chases you. You trip on a pebble and get caught. You have been moved to a higher security cell. Good luck escaping from there. ***

Would you like to RESTART, RESTORE a saved game, QUIT or UNDO the last command?

* * *

>s
Cell Room 1
Your cell is on the northern side of the room. There's another cell room to the east.

The security guard is in security checkpoint 2 and is headed towards cafeteria.

>z
Time passes.

The security guard is in cafeteria and is headed towards security checkpoint 1.

* * *

>z
Time passes.

The security guard is in Storage Room and is headed towards prison bathroom.

>z
Time passes.

The security guard is in prison bathroom and is headed towards Cell Room 1.

    *** The security guard sees you and chases you. You trip on a pebble and get caught. You have been moved to a higher security cell. Good luck escaping from there. ***

Would you like to RESTART, RESTORE a saved game, QUIT or UNDO the last command?

>restart
You beg to the guard to let you free. "If you can't do the time, don't do the crime," he replies coldly. You'll go insane if you stay in prison any longer. Find a way to escape without being caught by the guard by never being in the same room as him. The only place you're safe from is in the cell.

Jail Break
An Interactive Fiction by tendo19
Release 1 / Serial number 190405 / Inform 7 build 6M62 (I6/v6.33 lib 6/12N) SD

your cell
You're in a small cramped space with a think mattress and a filthy toilet. You notice that your cell is not fully locked. Go south to leave your cell.

* * *

>s
Cell Room 1
The cells are on the northern side of the room.There's another cell room to the east and the bathroom is to the south.

You can see a security guard and a metal door here.

The security guard is in Cell Room 1 and is headed towards Cell Room 2.

>s
(first opening the metal door)
It seems to be locked.

The security guard is in Cell Room 2 and is headed towards security checkpoint 2.

>x door
Enter six-digit code to unlock.

The security guard is in security checkpoint 2 and is headed towards cafeteria.

Please enter the six-digit locker pin code.

>112098
That's not a verb I recognise.

Please enter the six-digit locker pin code.

* * *

>z
Time passes.

The security guard is in prison bathroom and is headed towards Cell Room 1.

    *** The security guard sees you and chases you. You trip on a pebble and get caught. You have been moved to a higher security cell. Good luck escaping from there. ***

Would you like to RESTART, RESTORE a saved game, QUIT or UNDO the last command?

>z
Time passes.

Security guard is in prison bathroom. Security guard heads to Cell Room 1.

    *** The security guard sees you and chases you. You trip on a pebble and get caught. You have been moved to a higher security cell. Good luck escaping from there. ***

Would you like to RESTART, RESTORE a saved game, QUIT or UNDO the last command?

* * *

>w
You can't go that way.

Security guard heads to security checkpoint 2.

>e
Cell Room 2
There's another cell room to the west and the security room is to east. The cafeteria is to the south.

You can see Joe here.

Security guard heads to Cafeteria.

>talk to joe
You must supply a noun.

Security guard heads to security checkpoint 1.

>talk to Joe
You must supply a noun.

Security guard heads to South Security Room.

>talk to the joe
"How can I escape this place?" you ask.

"This prison is quite complex. You need to reach one of the security checkpoints without being caught," he replies. 

 You say, "Is there any way to sneak past the guards?"

"Whatever you do, don't be in the same room as the security guard. He always takes the same path so you should figure out where he is."

Security guard heads to Prison Bathroom.

* * *

>x toilet
You see bugs in the toilet. You freak out and jump away from the toilet.

The security guard is in security checkpoint 2 and is headed towards cafeteria.

* * *

>z
Time passes.

The security guard is in security checkpoint 2 and is headed towards cafeteria.

* * *

>z
Time passes.

The security guard is in prison bathroom and is headed towards Cell Room 1.

>l
your cell
You're in a small cramped space with a think mattress and a filthy toilet. You notice that your cell is not fully locked. Go south to leave your cell. 

The security guard is in Cell Room 1 and is headed towards Cell Room 2.

>s
Cell Room 1
The cells are on the northern side of the room.There's another cell room to the east and the bathroom is to the south.

You can see a metal door here.

The security guard is in Cell Room 2 and is headed towards security checkpoint 2.

>s
(first opening the metal door)
It seems to be locked.

The security guard is in security checkpoint 2 and is headed towards cafeteria.

>n
your cell
You're in a small cramped space with a think mattress and a filthy toilet. You notice that your cell is not fully locked. Go south to leave your cell. 

The security guard is in cafeteria and is headed towards security checkpoint 1.

>unlock door
You can't see any such thing.

>s
Cell Room 1
The cells are on the northern side of the room.There's another cell room to the east and the bathroom is to the south.

You can see a metal door here.

The security guard is in security checkpoint 1 and is headed towards Storage Room.

>unlock door
(with the metal door)
(first taking the metal door)
That's fixed in place.

The security guard is in Storage Room and is headed towards prison bathroom.

>l
Cell Room 1
The cells are on the northern side of the room.There's another cell room to the east and the bathroom is to the south.

You can see a metal door here.

The security guard is in prison bathroom and is headed towards Cell Room 1.

    *** The security guard sees you and chases you. You trip on a pebble and get caught. You have been moved to a higher security cell. Good luck escaping from there. ***

Would you like to RESTART, RESTORE a saved game, QUIT or UNDO the last command?

* * *

>z
Time passes.

The security guard is in prison bathroom and is headed towards Cell Room 1.

>s
Cell Room 1
The cells are on the northern side of the room.There's another cell room to the east and the bathroom is to the south.

You can see a security guard and a metal door here.

The security guard is in Cell Room 1 and is headed towards Cell Room 2.

>e
Cell Room 2
The cells are on the northern side of the room. There's another cell room to the west and the security room is to east. The cafeteria is to the south.

You can see a security guard, a rusted metal door and Joe here.

The security guard is in Cell Room 2 and is headed towards security checkpoint 2.

* * *

>s
Cell Room 1
The cells are on the northern side of the room.There's another cell room to the east and the bathroom is to the south.

You can see a security guard and a metal door here.

The security guard is in Cell Room 1 and is headed towards Cell Room 2.

>z
Time passes.

The security guard is in Cell Room 2 and is headed towards Security Room.

>e
Cell Room 2
The cells are on the northern side of the room. There's another cell room to the west and the security room is to east. The cafeteria is to the south.

You can see a rusted metal door and Joe here.

The security guard is in Security Room and is headed towards security checkpoint 2.

>e
Security Room
There's cell room to the west and a security checkpoint to the south.

You can see Security camera monitor and a bulletin board (in which is a note) here.

The security guard is in security checkpoint 2 and is headed towards cafeteria.

* * *

>z
Time passes.

The security guard is in prison bathroom and is headed towards Cell Room 1.

>z
Time passes.

You see the security guard walking to the next room.
The security guard is in Cell Room 1 and is headed towards Cell Room 2.

>z
Time passes.

The security guard is in Cell Room 2 and is headed towards Security Room.

>s
Cell Room 1
The cells are on the northern side of the room.There's another cell room to the east and the bathroom is to the south.

You can see a metal door here.

The security guard is in Security Room and is headed towards security checkpoint 2.

>z
Time passes.

The security guard is in security checkpoint 2 and is headed towards cafeteria.

* * *

>z
Time passes.

The security guard is in prison bathroom and is headed towards Cell Room 1.

>z
Time passes.

The security guard is in Cell Room 1 and is headed towards Cell Room 2.

    *** The security guard sees you and chases you. You trip on a pebble and get caught. You have been moved to a higher security cell. Good luck escaping from there. ***

Would you like to RESTART, RESTORE a saved game, QUIT or UNDO the last command?

* * *

>z
Time passes.

The security guard is in Cell Room 2 and is headed towards Security Room.

>z
Time passes.

Security guard heads to East Security Room.

>z
Time passes.

Security guard heads to security checkpoint 2.

>z
Time passes.

Security guard heads to Cafeteria.

>z
Time passes.

Security guard heads to security checkpoint 1.

>z
Time passes.

Security guard heads to South Security Room.

>z
Time passes.

Security guard heads to Prison Bathroom.

>z
Time passes.

Security guard heads to Cell Room 1.

* * *

>z
Time passes.

Security guard heads to Cell Room 2.

>z
Time passes.

Security guard heads to East Security Room.

>z
Time passes.

I beg your pardon?

>z
Time passes.

>s
Prison Bathroom
There's a cell room to the north and the cafeteria is to the east.

>n
Cell Room 1
There's another cell room to the east and the bathroom is to the south.

* * *

>e
Cell Room 2
There's another cell room to the west and the security room is to east. The cafeteria is to the south.

You can see Joe here.

>e
East Security Room
There's cell room to the west and a security checkpoint to the south.

You can see a security guard here.

>s
security checkpoint 2
There's a security room to the north and the cafeteria to the west.